abbey	tu viện
about	trong khoảng
above	ở trên
absolute	tuyệt đối
absolutely	chắc chắn rồi
absoluteparadise	tuyệt đối
absolutley	chắc chắn rồi
abysmal	vực thẳm
acacia	cây keo
acccomdating	gia nhập
acceptable	chấp nhận được
acces	truy cập
accidently	tình cờ
accomadated	có chỗ ở
accomadation	chỗ ở
accomadtion	chỗ ở
accommodation	chỗ ở
accomodations	chỗ ở
accor	tố cáo
accosted	tích lũy
accoustic	âm thanh
accueillant	người tố cáo
aceptable	có thể chấp nhận được
acient	cổ xưa
acoustic	âm thanh
acoutic	âm thanh
acti	hoạt động
action	hoạt động
activities	hoạt động
actually	thực ra
actualy	thực tế
adamant	cương quyết
add	thêm vào
addition	thêm vào
additional	bổ sung
addon	thêm vào
address	địa chỉ
adiacent	liền kề
adjacebt	liền kề
admin	quản trị viên
adorable	đáng yêu
advance	nâng cao
adventures	những cuộc phiêu lưu
adverftised	được quảng cáo
adveristed	tôn thờ
advisor	cố vấn
affordable	giá cả phải chăng
aficionado	người cuồng nhiệt
afraid	sợ
afterall	sau tất cả
afwul	kinh khủng
again	lần nữa
againi	một lần nữa tôi
againj	lạij
agency	đại lý
ages	lứa tuổi
ago	trước đây
agood	tốt
agradable	nông nổi
agrafirt	váy ngắn
agreable	dễ chịu
ailen	người ngoài hành tinh
air	không khí
airblade	lưỡi không khí
aircon	máy bay
aircond	điều hòa
airlines	các hãng hàng không
airmiles	dặm bay
airpirt	sân bay
airport	sân bay
airway	khí đạo
airy	thoáng đãng
aisling	lối đi
alas	chao ôi
albiet	mặc dù
alcarte	gọi món
alcove	hốc tường
alert	cảnh giác
alittle	một chút
all	tất cả
alley	ngõ
alleyway	ngõ
allowed	được phép
allows	cho phép
allready	tất cả đã
allright	được rồi
allsorts	tất cả các loại
allure	quyến rũ
allways	mọi cách
almond	hạnh nhân
almost	hầu hết
alo	a lô
aloe	nha đam
alot	rất nhiều
alothough	mặc du
alquilar	giống nhau
alquiler	thuật ngữ
already	đã sẵn sàng
alright	ổn thỏa
also	cũng thế
although	mặc du
am	là
amable	thân thiện
amamzing	kinh ngạc
amazibg	kinh ngạc
amazimg	kinh ngạc
amazing	kinh ngạc
amazing	tuyệt vời
ambassdor	đại sứ
amber	hổ phách
ambiance	môi trường xung quanh
ambience	môi trường xung quanh
amble	đi thong thả
amenable	chịu trách nhiệm
amenaties	tiện nghi
ameneties	tiện nghi
amenite	đá thạch anh
amenity	lể nghi
amenties	tiện nghi
amentities	tiện nghi
amieneties	hòa nhã
amore	tình yêu
amount	số tiền
ampenities	quần thể
amply	đủ
amzing	kinh ngạc
an	một
ancent	đi lên
anchovy	cá cơm
ancient	cổ xưa
and	và
ane	một
anemities	tiện nghi
angel	thiên thần
angered	tức giận
angle	góc
angst	sợ
anise	cây hồi
anithyng	bất cứ thứ gì
anjoy	vui mừng
anniversary	ngày kỷ niệm
annnoying	làm phiền
annoyance	khó chịu
annual	hàng năm
anonimous	vô danh
another	khác
answers	câu trả lời
ant	con kiến
antidote	thuốc giải độc
anwe	sợ hãi
any	bất kì
anything	bất cứ thứ gì
anyway	dù sao
anyways	dù sao đi nữa
ao	áo dài
apanda	một con gấu trúc
apartemnts	chung cư
apartment	căn hộ, chung cư
apartments	căn hộ
apologies	lời xin lỗi
app	ứng dụng
appaled	vỗ về
appart	ứng dụng
appartment	căn hộ
appartments	căn hộ
apple	táo
appreaciate	đánh giá
appreciable	đáng trân trọng
appreciation	sự đánh giá
apricot	quả mơ
april	tháng tư
apt	đúng cách
aqua	nước biển
aquaculture	nuôi trồng thủy sản
aquafeed	thức ăn thủy sản
aquarius	bảo bình
arbitrarily	tùy tiện
archer	người bắn cung
are	là
are	chúng tôi
area	khu vực
areas	khu vực
arent	không
arigant	kiêu ngạo
army	quân đội
aroma	hương thơm
aroma	mùi thơm
arpril	tháng tư
arrival	đến
arrive	đến
arrived	đã đến
arriving	đến nơi
arround	vòng vây
art	nghệ thuật
artisan	nghệ nhân
arts	nghệ thuật
asap	càng sớm càng tốt
asia	châu á
asian	châu á
ask	hỏi
asked	yêu cầu
asking	hỏi
assign	chỉ định
assistant	phụ tá
associates	cộng sự
at	tại
atmosphere	không khí
atmostphere	không khí
atosphere	không khí
atrium	tâm nhĩ
atsmosphere	không khí
attached	đính kèm
attendant	người phục vụ
attentiont	chú ý
attentive	niềm nở
attitude	thái độ
attracfion	sự hấp dẫn
aud	thử giọng
auditor	kiểm toán viên
aug	tháng 8
auguest	tháng tám
august	tháng tám
aurora	rạng đông
australia	châu úc
authentic	xác thực
auto	tự động
autumn	mùa thu
avaible	có sẵn
available	có sẵn
avalible	có sẵn
avarage	trung bình cộng
avatar	hình đại diện
average	trung bình cộng
aviod	tránh
avoid	tránh
avos	trái bơ
awaful	kinh khủng
award	giải thưởng
awards	giải thưởng
awared	cảnh giác
aweful	kinh hoàng
awesom	tuyệt vời
awesome	tuyệt vời
awful	kinh khủng
awkward	khó xử
awry	không như ý
awsome	tuyệt vời
azalea	cây đổ quyên
babecue	tiệc nướng ngoài trời
baby	đứa bé
babysister	người trông trẻ
bach	bạch
back	trở lại
backagge	quay ngược lại
backdrop	phông nền
backhome	về nhà
backless	không có lưng
backpacer	tây ba lô
backpacka	ba lô
backpacker	tây ba lô
backpackers	du khách ba lô
backpackerville	ba lô
backpacking	ba lô
backy	trở lại
bad	tệ
badge	huy hiệu
badger	lửng
badroom	phòng xấu
bag	túi
bager	người đóng thùng
bags	túi
baguette	bánh mì dài
baguettes	bánh mì baguette
bakery	cửa hàng bánh mì
balcony	ban công
balloon	quả bóng bay
bamboo	cây tre
bambooforest	rừng tre
ban	lệnh cấm
bana	chuối
banana	trái chuối
bancony	ban công
band	ban nhạc
bandaids	khăn rằn
bang	tiếng nổ
bangalow	nhà gỗ
bangkokian	người bangkok
banh	bánh
bank	ngân hàng
banquet	yến tiệc
banquit	yến tiệc
baquettes	bánh mì baguette
bar	quán ba
barbecue	tiệc nướng ngoài trời
barcode	mã vạch
bare	trần
barefoot	chân trần
barely	vừa đủ
bargain	trả giá
barisra	thợ pha cà phê
barista	thợ pha cà phê
barman	người phục vụ
barroness	nam tước
bartender	người pha chế rượu
bash	bấu víu
basic	căn bản
basil	húng quế
baskin	da bò
bat	con dơi
batender	người pha chế rượu
bath	bồn tắm
bathroom	phòng tắm
bathroon	phòng tắm
bathtub	bồn tắm
batter	bột nhồi
bawdyhouse	nhà bawdyhouse
bay	vịnh
bazaar	chợ
bday	sinh nhật
be	là
beacg	bờ biển
beach	bờ biển
beaches	bãi biển
beachfront	bãi biển
beachfront	bờ biển
beachhouse	nhà ở bờ biển
beachside	bên bờ biển
beakfast	bữa sáng
bean	hạt đậu
bear	chịu
bearable	có thể chịu được
beatiful	đẹp
beatiful	đẹp đẽ
beautifull	xinh đẹp
beautiful	xinh đẹp
beautifull	đẹp đẽ
beautifull	đẹp
beautifully	đẹp đẽ
beautifully	đẹp
beauty	sắc đẹp, vẻ đẹp
beautyful	đẹp đẽ
became	đã trở thành
becareful	hãy cẩn thận
because	bởi vì
become	trở nên
bed	giường
bedbugs	rệp
bedbugs	giường ngủ
bedder	người đi ngủ
beding	đi ngủ
bedlinen	khăn trải giường
bedroom	phòng ngủ
bedrooms	phòng ngủ
beds	giường ngủ
bedsheet	ga trải giường
bedsheets	ga trải giường
bedside	phòng ngủ
beef	thịt bò
been	đã
beep	tiếng kêu bíp
beeping	tiếng bíp
beepub	bíp bíp
beerfresh	bia tươi
beerpong	thùng bia
befast	nhanh lên
befind	tìm kiếm
before	trước
beggining	bắt đầu
behaviors	hành vi cư xử
behome	ở nhà
being	hiện hữu
belive	tin tưởng
bell	chuông
belle	bụng
bellhop	cửa hàng chuông
bellman	người đánh chuông
belly	bụng
belongings	đồ đạc
below	phía dưới
belt	thắt lưng
belw	ợ
benifit	có lợi
beofe	trước
berry	quả mọng
beside	bên cạnh
besides	ngoài ra
bespoke	thiết kế riêng
best	tốt
betel	trầu
better	tốt hơn
between	giữa
beutiful	đẹp
beverage	đồ uống
beware	coi chừng
beware	chăm sóc
beyobd	vượt ra ngoài
beyond	vượt ra ngoài
beyound	vượt ra ngoài
bfast	bữa ăn sáng
bich	bích
bich	bạch dương
bicicles	xe đạp
bicycle	xe đạp
bicylces	xe đạp
bicyle	xe đạp
bidaboard	bảng đấu thầu
bien	biên
bieu	biều
biffet	tiệc đứng
big	lớn
bigbus	xe buýt lớn
biggie	lớn
bigman	người đàn ông to lớn
bikerental	cho thuê xe đạp
bikeride	đạp xe
biketour	chuyến đi bằng xe đạp
bill	hoá đơn
bin	thùng rác
birdhouse	chuồng chim
birding	tiếng chim
birthday	sinh nhật
bistro	quán rượu
bittet	đắng
blacklist	danh sách đen
blare	chói lọi
blaring	bùng nổ
blessing	ban phước
blip	đốm sáng
bliss	phúc lạc
block	khối
bloke	nở hoa
blue	màu xanh da trời
bluebell	chuông xanh
bluelake	hồ xanh
blurb	sự lộn xộn
board	bảng
boardwalk	lối đi lát ván
boat	thuyền
boattour	thuyên du lịch
body	thân hình
boggling	nói dối
bohemien	phóng túng
bol	bu lông
bond	liên kết
bonsai	cây cảnh
bonus	tặng kem
boo	ụt
book	sách
booked	đã đặt trước
booking	đặt trước
bookingservice	dịch vụ đặt chỗ
boom	bùng nổ
bordet	giáp ranh
boss	ông chủ
bossman	ông chủ
bot	người máy
bouique	cửa hàng
bouns	giới hạn
bourbon	rượu whisky ngô
bout	cơn
boutique	cửa hàng
bowls	bát
bowngalows	nhà gỗ
box	cái hộp
boys	những cậu bé
bra	áo lót
brackfast	bữa ăn sáng
braethtaking	ngoạn mục
brainstorming	động não
branch	chi nhánh
brand	nhãn hiệu
brandlaureate	nhãn hiệu
brandy	rượu mạnh
brasserie	quán bia
brdige	cầu
breackfast	bữa ăn sáng
break	phá vỡ
breakfadt	bữa ăn sáng
breakfast	bữa ăn sáng
breakfeat	bữa ăn sáng
breakffast	bữa ăn sáng
breakfirst	đột phá
breakkfast	bữa ăn sáng
breaklfast	bữa ăn sáng
breaksts	bẻ gãy
breaktfast	bữa ăn sáng
breaktime	giờ giải lao
breaky	vỡ
breaky	vỡ vụn
breastfast	thức ăn nhanh
breathtaking	ngoạn mục
brecky	rượu bia
breifs	tóm tắt
brekfast	bữa sáng
brekky	rượu bia
breskfast	bữa ăn sáng
brew	ủ
brick	gạch
bridge	cầu
brie	phô mai mềm của pháp
brige	bờ vực
bright	sáng
brightest	sáng nhất
brillant	rực rỡ
brilliant	xuất sắc
brillient	rực rỡ
brings	mang lại
bro	anh bạn
broad	rộng lớn
broken	bị hỏng
brown	nâu
brownie	bánh hạnh nhân
brunch	bữa sáng muộn
brunch	chiếc
brunch	bữa nửa buổi
bsthroom	phòng tắm
bub	bọt
buck	cái xô
bud	chồi
buddha	đức phật
buddy	bạn bè
budget	ngân sách
buding	chớm nở
buffalo	trâu
buffer	đệm
buffet	tiệc đứng
bufffet	tiệc đứng
buffolo	trâu
bufft	tiệc đứng
bugalow	nhà gỗ
buggy	có lỗi
bugs	lỗi
buiding	xây dựng
buidling	xây dựng
building	xây dựng
built	được xây dựng
bulgalow	nhà gỗ
bull	bò đực
bum	ăn mày
bun	bún
bunaglow	nhà gỗ
bunaglows	nhà gỗ
bunch	bó
bungallow	nhà gỗ
bungalow	nhà gỗ
bungalows	nhà gỗ
bungarlow	nhà gỗ
buon	buôn
burger	bánh mì kẹp thịt
burn	đốt cháy
burrow	hang hốc
bus	xe buýt
bush	cây bụi
buss	hôn
bussy	bận rộn
busy	bận
but	nhưng
butffet	tiệc đứng
butler	quản gia
butter	bơ
butterbeer	bia bơ
bycicle	xe đạp
bycicles	xe đạp
bye	tạm biệt
byes	tạm biệt
cabbie	người lái taxi
cackling	nói nhỏ
cactus	cây xương rồng
cactusrine	cây xương rồng
caf	quán cà phê
cafe	quán cà phê
cafebar	quán cà phê
cagle	ca khúc
cahoots	móc ngoặc
cake	bánh ngọt
calculate	tính toán
calibre	tầm cỡ
call	gọi
called	gọi là
calm	điềm tĩnh
came	đã đến
camel	lạc đà
camellia	hoa trà
camera	máy ảnh
camon	cảm ơn
camping	cắm trại
can	có thể
canal	con kênh
canary	chim hoàng yến
cancel	hủy
canceling	hủy bỏ
candy	kẹo
cannot	không thể
canooing	chèo thuyền
cantho	cần thơ
canyoneering	người đóng hộp
canyouning	đường hầm
cap	mũ lưỡi trai
caprilicious	đáng yêu
caps	mũ lưỡi trai
capsule	viên con nhộng
caption	chú thích
car	xe hơi
card	thẻ
cardinal	hồng y
care	quan tâm
careful	cẩn thận
carefull	chăm sóc đầy đủ
carey	cẩn thận
caring	quan tâm
carry	thực hiện
casas	áo cà sa
case	trường hợp
cash	tiền mặt
cashier	thu ngân
casino	sòng bạc
cassia	trái bả đậu
castaway	người đi thiến
cat	con mèo
catcat	mèo mèo
cathedral	nhà thờ lớn
catheral	ống thông
caveat	cảnh báo trước
caving	hang động
cctv	camera quan sát
cell	ô
celsius	độ c
center	trung tâm
central	trung tâm
centrally	trung ương
centre	trung tâm
century	thế kỷ
ceramics	gốm sứ
certainty	chắc chắn
chagre	sạc điện
chai	cái ghế
chain	chuỗi
cham	chăm
champagne	rượu sâm banh
change	thay đổi
changes	thay đổi
chanh	chánh
charge	sạc điện
charged	tính phí
charging	sạc
charm	quyến rũ
charming	duyên dáng
chat	trò chuyện
chau	châu
cheap	rẻ
cheat	lừa đảo
cheating	gian lận
cheats	gian lận
cheched	đã kiểm tra
check	kiểm tra
checked	đã kiểm tra
checkeout	rô to
checkin	đăng ký vào
checkincheckout	đăng nhập. thoát ra
checking	kiểm tra
checkout	thủ tục thanh toán
cheep	chim kêu
cheeper	chim kêu
cheer	vui lên
cheerful	vui lòng
cheers	chúc mừng
cheetah	con báo
chef	bếp trưởng
chekin	đăng ký vào
chekout	thủ tục thanh toán
cherish	trân trọng
cherry	quả anh đào
cherrys	quả anh đào
chesses	cờ vua
chest	ngực
chiang	tưởng
chic	sang trọng
chicken	thịt gà
chikdren	bọn trẻ
child	đứa trẻ
chili	ớt
chillax	làm lạnh
chillbox	thùng lạnh
chillin	làm lạnh
chilling	rùng mình
chillout	thư giãn
chin	cái cằm
china	trung quốc
chinatown	khu phố tàu
chineese	người trung quốc
chips	khoai tây chiên
chiselling	đục đẽo
chit	chít
chocol	sô cô la
choice	lựa chọn
choice	sự lựa chọn
choices	sự lựa chọn
choicing	sự lựa chọn
choose	chọn
chopsticks	đũa
chose	đã chọn
christian	cơ đốc giáo
christine	nguyên sơ
christmas	giáng sinh
church	nhà thờ
cigarets	thuốc lá
cigarettes	thuốc lá
ciggies	xì gà
cinema	rạp chiếu phim
citadel	thành lũy
cititel	thành phố
city	thành phố
cityit	thành phố
citypoint	điểm thành phố
cityview	cảnh quan thành phố
claim	yêu cầu
claimed	tuyên bố
clam	yên tĩnh
clases	hợp lại
class	lớp học
classic	cổ điển
classy	sang trọng
clay	đất sét
clea	chẻ đôi
cleadly	khôn ngoan
clean	dọn dẹp
cleaned	làm sạch
cleaners	chất tẩy rửa
cleaness	sạch sẽ
cleanstaff	làm sạch
cleen	làm sạch
click	nhấp chuột
cliff	vách đá
cliff	khách hàng
clip	kẹp
close	đóng
closeby	gần đây
closeto	gần với
clostrophobic	nỗi ám ảnh
clothes	quần áo
cloud	đám mây
clouds	mây
cloudy	nhiều mây
clover	cỏ ba lá
clran	dọn dẹp
club	câu lạc bộ
clubhouse	nhà câu lạc bộ
clud	loảng xoảng
clup	tiếng vỗ tay
coacroaches	con gián
coast	bờ biển
coathangers	áo choàng
cob	lõi ngô
cobran	rắn hổ mang
cocacola	cô-ca cô-la
cockerel	gà trống
coco	kén
cocobus	xe buýt
coconut	dừa
cocoon	cái kén
cod	cá tuyết
code	mã
coffe	cà phê
coffee	cà phê
coffeebean	hạt cà phê
cofffee	cà phê
cog	răng cưa
coke	than cốc
cokes	than cốc
collor	người cắt dán
combination	sự phối hợp
combo	bộ_sản_phẩm
come	đến
comeback	sự trở lại
comes	đến
comfertble	thoải mái
comforable	thoải mái
comfortable	thoải mái
comfotable	thoải mái
comfy	thoải mái
coming	sắp tới
coming	đến
comment	bình luận
comofortable	thoải mái
compact	gọn nhẹ
company	công ty
comparison	sự so sánh
compendiuem	bản tóm tắt
compering	so sánh
compfortable	thoải mái
compfty	tài giỏi
complain	than phiền
complained	phàn nàn
complaint	lời phàn nàn
complete	hoàn thành
complex	phức tạp
comportable	có thể so sánh được
computer	máy vi tính
con	con lừa
conceirge	nhân viên hướng dẫn
concept	ý tưởng
concerned	lo âu
concierge	nhân viên hướng dẫn
concierge	người hướng dẫn
condiciona	lời chúc phúc
condicioned	có điều kiện
conditional	có điều kiện
conditioner	dầu xả
conditioning	điều hòa
conditonal	có điều kiện
condo	căn hộ
condos	căn hộ
condote	dẫn lời
condotel	căn hộ du lịch
conect	hình nón
conf	tâm sự
conference	hội nghị
confirm	xác nhận
confirmation	xác nhận
confirmed	đã xác nhận
confort	kết tội
confortable	thoải mái
confortable	có thể kết nối
confortably	thoải mái
confy	hoa giấy
conifer	hạt trần
conkhach	ốc xà cừ
connect	kết nối
connected	kết nối
connection	kết nối
cons	nhược điểm
consept	thông minh
considering	đang cân nhắc
contact	tiếp xúc
container	thùng đựng hàng
containing	chứa đựng
continental	lục địa
continue	tiếp tục
contras	trái ngược
convenience	tiện
conveniences	tiện nghi
convenient	tiện lợi
convention	quy ước
convientely	thuận tiện
convinces	thuyết phục
convinent	tiện lợi
convinience	tiện
conviniently	thuận tiện
coocked	nấu chín
coocking	nấu nướng
cooffe	cà phê
cook	nấu ăn
cooker	nồi cơm điện
cookie	bánh quy
cookies	bánh quy
cooking	nấu nướng
cool	mát mẻ
coop	chuồng ngựa
copped	che đậy
copycats	bắt chước
core	cốt lõi
corkscrew	đồ mở nắp chai
corn	ngô
corner	góc
corny	xưa
corona	hào quang
corral	chuồng ngựa
correct	chính xác
corredor	thợ sửa xe
correos	tương quan
corridor	công ty cổ phần
corse	thô
corteous	nhã nhặn
corteseous	kháu khỉnh
cosmopolitan	khắp thế giới
cosy	ấm cúng
cothe	có thể
cottage	nhà tranh
cottages	trang trại
cotton	chất thun
cotton	bông
cotu	cơtu
could	có thể
couldnt	không thể
count	đếm
counter	quầy tính tiền
counters	quầy giao dịch
couple	cặp đôi
couples	các cặp đôi
coupon	phiếu mua hàng
court	tòa án
coustmer	khách hàng
cousy	anh em họ
coworking	làm việc chung
cozy	ấm cúng
cpmpletely	hoàn toàn
craft	thủ công
cranes	cần cẩu
crap	tào lao
crappy	thèm thuồng
crash	tai nạn
craving	thèm muốn
crawl	thu thập thông tin
crazy	khùng
creak	cót két
creating	tạo ra
crepe	bánh crepe
crepes	bánh crếp
cricket	bóng chày
cristmas	giáng sinh
croak	lạch cạch
crocodile	cá sấu
croissant	bánh sừng bò
crony	nối khố
croplife	cây trồng
crossaint	bánh sừng bò
crown	vương miện
crowning	vương miện
cruis	du thuyền
cruise	du thuyền
cruises	du lịch trên biển
crystal	pha lê
cub	đàn con
cuc	dưa chuột
cuc	cúc
cue	gợi ý
cuing	giám định
culinar	người nói chuyện
culture	văn hóa
cuong	cường
cup	cốc
curt	cộc lốc
customer	khách hàng
customers	khách hàng
cute	dễ thương
cutee	dễ thương
cuteeee	dễ thương
cutlery	dao kéo
dac	đắc
daily	hằng ngày
daisy	hoa cúc
dalat	đà lạt
dam	đầm
dam	đập
damage	hư hại
damg	chết tiệt
damn	chỉ trích
damp	ẩm ướt
danang	đà nẵng
dance	nhảy
dark	tối
date	ngày
day	ngày
days	ngày
daytrippers	ngày của người du ngoạn
ddiscovery	khám phá
deal	thỏa thuận
dealtoday	xử lý ngày hôm nay
dean	trưởng khoa
dearest	thân yêu nhất
deathtrap	cái chết
decanter	bình gạn
december	tháng mười hai
decent	phong nhã
decently	đoan trang
decided	quyết định
deco	trang trí
decorate	trang trí
decorated	trang trí
decoration	trang trí
dedicated	chuyên dụng
deep	sâu
defenetely	chắc chắn
defenetly	chắc chắn
deffinatley	chắc chắn
definate	khử mùi
definatley	chắc chắn
definetely	chắc chắn
definetley	chắc chắn
definitely	định nghĩa
definitley	chắc chắn
defonitely	chắc chắn
delay	sự chậm trễ
deli	cửa hàng thức ăn ngon
deli	đồ nguội
delicious	ngon
deliciuos	thơm ngon
delicous	thơm ngon
delight	hân hoan
delightful	thú vị
delious	mê sảng
delta	đồng bằng
deluxe	sang trọng
demanded	yêu cầu
denmark	đan mạch
denonstrates	minh chứng
department	phòng ban
depoait	tiền gửi
deposit	tiền gửi
desaster	sa mạc
descibe	diễn tả
deserves	xứng đáng
desetved	được yêu thích
desgin	thiết kế
design	thiết kế
designed	thiết kế
designing	thiết kế
desk	bàn
despite	bất chấp
despues	khinh thường
dessole	áo lót
dest	đích
destination	nơi đến
detailed	chi tiết
detox	giải độc
detox	cai nghiện
devine	nuốt chửng
devoted	hết lòng
dew	sương
diamond	kim cương
dicovery	khám phá
didint	không
didn	không
didnt	không
die	chết
dien	điền
diep	điệp
diet	chế độ ăn
different	khác nhau
dificult	khó khăn
digs	đào
dimly	lờ mờ
dine	ăn cơm trưa
dingy	bẩn thỉu
dining	ăn uống
dinner	bữa tối
dinning	ăn tối
dip	nhúng
direct	thẳng thắn
directeur	người trực tiếp
director	giám đốc
dirtiness	bẩn thỉu
dirty	dơ bẩn
disapointed	thất vọng
disapointing	thất vọng
disappointed	thất vọng
disappointing	thất vọng
disapponting	khai thác
disclaimer	khước từ
disco	sàn nhảy
discorvery	khám phá
discount	giảm giá
discover	khám phá
discovery	khám phá
discovey	khám phá
discusting	thảo luận
discutiendo	phản đối
disgusted	tệ
dishing	món ăn
disovery	khám phá
disputable	không thể tranh cãi
disrespected	không tôn trọng
dissapointed	thất vọng
dissapointing	thất vọng
disspointed	thất vọng
district	huyện
distub	làm phiền
distubed	bị làm phiền
ditto	như trên
diving	lặn
division	sự phân chia
do	làm
dod	né tránh
dodgey	né tránh
doenst	không
does	làm
doesnt	không
dog	chó
doing	đang làm
dollar	đô la
domance	thống trị
don	đừng
done	làm xong
dont	không
door	cửa
doorgil	khung cửa
doorgirl	cô gái gác cửa
doorhandle	tay nắm cửa
doorman	người gác cửa
doormen	người gác cửa
dope	gây nghiện
doreamon	đôrêmon
dorm	ký túc xá
dormbeds	giường ngủ tập thể
dormworld	thế giới ký túc xá
dormy	ngủ đông
doting	lẩm cẩm
double	gấp đôi
doughy	nhão nhoét
doule	lừa đảo
down	xuống
downside	nhược điểm
downstair	tầng dưới
downtown	trung tâm thành phố
dragon	rồng
drap	khăn trải giường
drawers	ngăn kéo
dreamers	những người mơ mộng
dreaming	đang mơ
dreams	những giấc mơ
dress	trang phục
drew	đã vẽ
dribbled	rê bóng
drikke	nhỏ giọt
drink	uống
drinkand	uống rượu
drinks	đồ uống
driver	người lái xe
drivermr	người lái xe
drivers	trình điều khiển
drivers	tài xế
drjnk	uống
dryer	máy sấy khô
dthoai	điện thoại
duc	đức
duck	con vịt
dudes	anh chàng
duey	đến hạn
duffle	vải thô
duluxe	sang trọng
dung	phân
dungeon	ngục tối
duoing	bộ đôi
duong	dương
duplex	song công
during	suốt trong
durty	bẩn thỉu
dust	bụi bặm
dusted	phủi bụi
dusty	bụi bặm
duty	nhiệm vụ
duver	thợ lặn
duvet	chăn bông
duyen	duyên
dvd	đĩa dvd
early	sớm
ears	đôi tai
earsy	có tai
earth	trái đất
easier	dễ dàng hơn
east	phía đông
easy	dễ dàng
easygoing	dễ dãi
eat	ăn
eatery	quán ăn
eaxample	thí dụ
ebb	hạ xuống
eccellent	tuyệt vời
ecean	đại dương
ecellent	thông minh
echo	tiếng vang
echoing	tiếng vang
eclipse	nhật thực
eco	sinh thái
ecologic	sinh thái học
ecological	sinh thái
ecspecially	đặc biệt
ect	vân vân
ede	ê đê
eden	vườn địa đàng
edition	phiên bản
eftpose	đa năng
eh	hở
eight	tám
elavator	thang máy
electric	điện
elegance	trang nhã
elegant	thanh lịch
elevator	thang máy
elite	ưu tú
else	khác
emerald	ngọc lục bảo
emotion	cảm xúc
empire	đế chế
emplacement	sự thay thế
employee	nhân viên
emproved	tán thành
empty	trống
emtpy	trống
end	kết thúc
enegergy	năng lượng
engineer	kỹ sư
engish	tiếng anh
englisch	tiếng anh
english	tiếng anh
englisheverything	tiếng anh
enjo	ra lệnh
enjoy	thưởng thức
enjoyable	thú vị
enjoyed	rất thích
enough	đủ
enouh	đủ
ensuite	phòng tắm
ensuites	quần áo
entertaining	giải trí
enthusiam	hăng hái
enthusiasm	hăng hái
enthusiastic	nhiệt tâm
entrace	cuốn theo
entrance	cổng vào
entree	đồng ý
eo	eo ơi
epic	sử thi
episode	tập phim
eqipment	trang thiết bị
equipment	trang thiết bị
er	ờ
escape	bỏ trốn
escapes	chạy trốn
especcialy	đặc biệt
especial	đặc biệt
especially	đặc biệt
especillay	đặc biệt
espessialy	đặc biệt
espresso	cà phê espresso
essence	bản chất
establishment	thành lập
estate	động sản
estuary	cửa sông
etc	vân vân
ethnic	dân tộc
ethusiasim	hăng hái
euthusiastic	nhiệt tâm
evason	bao giờ
even	cũng
evening	tối
event	biến cố
ever	không bao giờ
evergreen	thường xanh
everuthing	mọi điều
every	mỗi
everybody	mọi người
everyday	hằng ngày
everyone	tất cả mọi người
everything	mọi điều
everythink	mọi suy nghĩ
everywhere	mọi nơi
evetything	mọi điều
eveyday	hằng ngày
eveyone	tất cả mọi người
evryday	hằng ngày
ex	ví dụ
excelent	tuyệt vời
excellemt	thông minh
excellences	xuất sắc
excellent	xuất sắc
excellentlent	xuất sắc
exceptional	đặc biệt
exceptionnel	kênh ngoại lệ
exchange	đổi
excilent	đặc biệt
excillent	thông minh
exciting	thú vị
excutive	điều hành
exec	người điều hành
execelent	thông minh
execellent	thông minh
executie	người điều hành
executive	điều hành
exelent	cường tráng
exellent	tuyệt vời
exentent	hiện tại
exepcted	hy vọng
exeptional	đặc biệt
exercise	tập thể dục
exhausted	kiệt sức
exigences	sự xuất hiện
expecially	đặc biệt
expectations	kỳ vọng
expectationsthat	kỳ vọng
expected	hy vọng
exped	thám hiểm
expencive	khai khẩn
expensive	đắt
experiance	kinh nghiệm
experiencd	kinh nghiệm
experience	kinh nghiệm
experienced	có kinh nghiệm
experiences	kinh nghiệm
experiment	thí nghiệm
experince	kinh nghiệm
experirence	kinh nghiệm
expierience	kinh nghiệm
explor	giải thích
exploring	khám phá
express	bày tỏ
expressthanks	bày tỏ sự cảm ơn
exqusite	tinh tế
extend	mở rộng
extra	thêm
extrabed	giường phụ
extreme	cực
extremely	vô cùng
exuses	lời bào chữa
eyes	đôi mắt
fabulious	tuyệt vời
fabulous	tuyệt vời
facelifting	đổi mới
faces	những khuôn mặt
facilities	cơ sở vật chất
facillites	cơ sở vật chất
facillity	cơ sở
fact	thực tế
factory	nhà máy
faff	ngu ngốc
fail	thất bại
failed	thất bại
fairies	tiên nữ
fairy	nàng tiên
fajitas	cà ri
fake	giả mạo
falcility	sự giả dối
falling	rơi
falls	ngã
familia	quen thuộc
familie	gia đình
familly	gia đình
family	gia đình
familydinners	gia đình
familydinners	bữa tiệc gia đình
fammily	gia đình
famous	nổi danh
fan	quạt
fanastic	cuồng tín
fancy	mến
fantastic	tuyệt diệu
farm	nông trại
fascility	cơ sở
fastfood	thức ăn nhanh
fat	mập
fault	lỗi
faulty	bị lỗi
fav	yêu thích
favorite	yêu thích
fax	số fax
fday	thứ hai
feast	tiệc
fee	học phí
feed	cho ăn
feedback	phản hồi
feel	cảm thấy
feeling	cảm giác
feet	đôi chân
felt	cảm thấy
fengshui	phong thủy
feral	hoang dã
ferris	đu quay
festival	lễ hội
ficility	cơ sở
field	cánh đồng
fifteen	mười lăm
fig	quả sung
figured	hình dung
fiilling	đổ đầy
fiinger	ngón tay
file	tập tin
filght	chuyến bay
film	phim ảnh
finally	cuối cùng
find	tìm thấy
finds	tìm thấy
fine	khỏe
finest	tốt nhất
finger	ngón tay
finish	hoàn thành
finnegans	người finnegans
fiore	tốt
fire	ngọn lửa
firefly	con đom đóm
firework	pháo hoa
fireworks	bắn pháo hoa
firsly	đầu tiên
first	đầu tiên
firtsly	đầu tiên
fish	cá
fisher	người câu cá
fisrt	đầu tiên
fitness	sự khỏe khoắn
five	số năm
flam	ngọn lửa
flame	ngọn lửa
flamingo	chim hồng hạc
flan	bánh flan
flash	tốc biến
flashsale	bán chớp nhoáng
flavoursome	hương vị
flicking	nhấp nháy
flip	lật
flipflops	dép tông
flipside	lật mặt
floating	nổi
floor	sàn nhà
flop	thất bại
flops	thất bại
flower	bông hoa
flowers	những bông hoa
foam	bọt
foggy	sương mù
foir	ngựa con
following	tiếp theo
food	món ăn
foodie	người sành ăn
foodie	người ăn uống
foods	thức ăn
foodstreets	thực phẩm
fooled	bị lừa
foot	chân
footbath	bồn rửa chân
footy	có chân
force	lực lượng
foreign	ngoại quốc
forest	rừng
foret	báo trước
forever	mãi mãi
foriegner	người nước ngoài
forit	cho nó
form	kiểu dáng
forniture	đồ đạc
fort	pháo đài
forth	ra ngoài
fortunate	may mắn
fortune	vận may
forty	bốn mươi
forum	diễn đàn
forvthem	cho họ
found	tìm
founder	người sáng lập
fount	đài phun nước
four	bốn
fourday	bốn ngày
fourth	thứ tư
fovourite	yêu thích
foward	đi trước
fragrance	mùi thơm
frangipani	hoa sứ
frankly	thẳng thắn
frd	thứ ba
freaking	quái đản
free	miễn phí
freebies	tiền thưởng
freedomland	đất tự do
freeeee	miễn phí
freesize	kích cỡ lớn
freestanding	tự do
freestyle	tự do
freey	chiếc phà
freezer	tủ đông
freind	tự do
frendly	tự do
frendship	hữu nghị
fresh	tươi
fridge	tủ lạnh
friedly	chiên
frieldly	thân thiện
friend	bạn bè
friendly	thân thiện
friendlybut	thân thiện nhưng
friendlyim	thân thiện
friendlytake	thân thiện
friends	bạn bè
frienfly	thân thiện
frienldy	thân thiện
frienly	thân thiện
friensdly	phù phiếm
frig	gàn
fritters	khoai tây chiên
friut	trái cây
fro	sương giá
from	từ
front	trước mặt
frontside	mặt trước
frtont	trước mặt
fruit	trái cây
fruite	trái cây
fruut	trái cây
frypans	chảo rán
fucking	tệ
fue	chết tiệt
full	đầy
fullmoon	trăng tròn
fully	đầy đủ
fun	vui vẻ
funcioning	hoạt động
funemployment	thiếu việc làm
funfact	sự thật thú vị
funky	sôi nổi
funny	buồn cười
furbished	có lông
furnished	trang bị
furniture	đồ nội thất
furnitured	trang bị
fusion	dung hợp
fusionrisort	hợp nhất
fuss	làm phiền
fusty	xưa
future	tương lai
fwd	dâm đãng
gala	dạ tiệc
galaxy	ngân hà
gallery	bộ sưu tập
game	trò chơi
gamer	game thủ
games	trò chơi
gang	băng nhóm
ganh	ganh đua
gap	lỗ hổng
garde	làm vườn
garden	vườn
gardens	vườn
gas	khí ga
gate	cánh cổng
gateman	người gác cổng
gave	đã cho
gdinh	gia định
geap	nuốt nước bọt
gecko	con tắc kè
geckos	tắc kè
gelish	hơi sệt
gentlemab	quý ông
genuine	chính hãng
get	được
getaroom	nhận phòng
getaway	nơi nghỉ ngơi
getting	nhận được
ghen	ghen tị
ghostly	ma quái
ghotel	con ma cà rồng
giantuyet	người khổng lồ
giap	giáp
giat	con dê
gieo	gieo hạt
ginormous	to lớn
gioi	giời
girl	con gái
girls	các cô gái
girls	con gái
give	đưa cho
glad	vui vẻ
glamour	sự hào nhoáng
glanced	liếc
glass	cốc thủy tinh
glazed	tráng men
global	toàn cầu
glod	lóng lánh
glomad	vui mừng
go	đi
goal	mục tiêu
goatmeat	thịt dê
gob	ngấu nghiến
godd	trời ơi
goings	đi
gold	vàng
golden	vàng
golfview	đánh gôn
good	tốt
goodbye	tạm biệt
goodluck	chúc may mắn
goodrecommend	chúc mừng
googlemaps	bản đồ google
goood	tốt
gooseberries	quả lý gai
gopro	đi pro
gorgeous	rực rỡ
gorgeously	lộng lẫy
gorget	tiện ích
got	có
goumet	người sành ăn
goup	đi lên
gout	bệnh gout
grab	vồ lấy
grace	ân huệ
grade	cấp
graduation	tốt nghiệp
graffiti	vẽ tranh lên tường
grand	lớn
grande	ông lớn
grandkids	cháu gái
grass	cỏ
great	tuyệt quá
greatly	rất nhiều
greeeeeennnnnnn	màu xanhnnnnnn
greek	người hy lạp
green	màu xanh lá
greenaway	cây xanh
greenery	cây xanh
greet	chào
grend	màu xám
grey	màu xám
grill	nướng
gro	trưởng thành
groc	cái rãnh
gross	tổng
grotty	sự thô lỗ
ground	đất
group	nhóm
grouse	cằn nhằn
grumpy	gắt gỏng
guess	phỏng đoán
guest	khách mời
guesthouse	nhà khách
guests	khách
guidance	hướng dẫn
guinea	chuột lang
guinely	chân thật
guitar	đàn ghi ta
gurgling	ọc ọc
gutted	rút ruột
guy	chàng
guys	các bạn
guyssss	thằng khốn
gym	phòng thể dục
ha	hà
haapy	vui mừng
habitaciones	thói quen
hack	gian lận
had	đã có
haggle	mặc cả
hai	hải
haiphong	hải phòng
haipong	hải phòng
hair	tóc
hairgrip	kẹp tóc
hall	đại sảnh
hallo	ê
halo	hào quang
halong	hạ long
halong	dài
halonh	hạ long
ham	giăm bông
hamburger	bánh hamburger
hamlet	ấp
hammers	búa
hamocks	võng
handmock	tay cầm
handsome	đẹp
hangar	nhà chứa máy bay
hanging	treo cổ
hangout	đi ra ngoài
hanriver	sông han
hao	hảo
hapiness	hạnh phúc
hapoened	đã xảy ra
happend	xảy ra
happy	vui mừng
happys	hạnh phúc
happys	xảy ra
harbour	hải cảng
hard	cứng
harmony	hòa hợp
hat	mũ
hau	hậu
have	có
havea	có một
haven	trú ẩn
having	đang có
hay	cỏ khô
hazard	nguy hiểm
hazardous	nguy hiểm
hazelnut	hạt phỉ
head	cái đầu
headscratcher	thợ cạo đầu
health	sức khỏe
healthy	khỏe mạnh
heat	nhiệt
heath	cây thạch thảo
heaven	thiên đường
heck	quái
helfpul	hữu ích
helful	hữu ích
helfull	hữu ích
hello	xin chào
heloed	say mê
heloful	hữu ích
help	cứu giúp
helpful	hữu ích
helpfulbuffet	hữu ích
helpfull	hữu ích
helpfully	hữu ích
hem	viền
hen	gà mái
her	cô ấy
herb	thảo mộc
herbal	thảo dược
here	đây
heritage	gia tài
hero	anh hùng
hers	của cô ấy
hesitant	do dự
hesitate	do dự
hey	chào
hi	chào
hibiscus	dâm bụt
hidden	ẩn
hideaway	ẩn đi
hideaways	nơi ẩn náu
hideout	nơi ẩn náu
hideway	ẩn đi
hien	hiền
hier	chào
highchairs	ghế cao
higher	cao hơn
highland	cao nguyên
highlight	điểm nổi bật
hightly	cao ngạo
highway	xa lộ
higland	cao nguyên
higly	cao nhất
higly	cao cấp
hii	xin chào
hil	xin chào, tôi
hilarious	vui nhộn
hill	đồi núi
hills	những ngọn đồi
hills	đồi núi
hillside	sườn đồi
hilltop	đỉnh đồi
hioliday	ngày lễ
hip	hông
hippo	con hà mã
his	của anh ấy
hishown	của mình
historic	mang tính lịch sử
history	lịch sử
hit	đánh
hitea	xin chào trà
hoang	hoàng
hoards	tích trữ
hoarsening	khản giọng
hoast	nâng cao
hochimihn	hồ chí minh
hochimin	hồ chí minh
hochiminh	hồ chí minh
hogging	cuốc đất
hoisin	nước tương đen
hoit	cuốc đất
hole	hố
holiday	ngày lễ
holidaymoon	kỳ nghỉ
holidays	ngày lễ
holtel	khách sạn
holyday	ngày thánh
home	trang chủ
home	nhà
homecooked	nấu chín
homecooking	nấu ăn ở nhà
homely	thân thiện
homely	quê mùa
homemade	tự làm
homes	những ngôi nhà
homesta	nhà trọa
homestay	ở nhà người bản xứ
homestead	nhà ở
homestyle	kiểu nhà
hometown	quê nhà
hometsay	ở nhà người bản xứ
homey	ấm cúng
homie	người nhà
homstay	ở nhà người bản xứ
honey	mật ong
honeymoon	tuần trăng mật
honeymoontrip	chuyến đi tuần trăng mật
hong	hồng
hongkong	hồng kông
honk	bấm còi
honking	bấm còi
honnestly	thành thật
hooker	gái điếm
hooting	nâng đỡ
hop	nhảy lò cò
horizn	chân trời
horizon	chân trời
horrendous	kinh khủng
horrible	kinh khủng
horrified	đã xác nhận
horrifying	chăm sóc
horror	kinh dị
horrors	kinh dị
horse	con ngựa
hospitable	hiếu khách
hospital	bệnh viện
hospitality	lòng hiếu khách
hosstes	bà chủ
host	tổ chức
hostel	nhà trọ
hostell	nhà trọ
hostels	ký túc xá
hostess	bà chủ
hosting	lưu trữ
hostle	nhà trọ
hosts	máy chủ
hot	nóng bức
hotel	khách sạn
hotelexcellent	khách sạn tuyệt vời
hotelfriendly	khách sạn
hotelfriendly	thân thiện
hotellocation	vị trí khách sạn
hotels	nhiều khách sạn
hotes	nhiều khách sạn
hotle	khách sạn
hotline	đường dây nóng
hotpot	lẩu
hotspring	suối nóng
hottub	bồn nước nóng
hour	giờ
hours	giờ
house	nhà ở
housekeep	quản gia
housekeeper	người quản gia
housekeeping	dọn phòng
housemade	làm tại nhà
houseskipping	bỏ nhà đi
houskeeping	dọn phòng
hovever	tuy nhiên
how	làm sao
howerver	tuy nhiên
howls	tiếng hú
hoziron	chân trời
hr	giờ
htoel	khách sạn
huan	huân
huanh	hoàng
hubbub	huyên náo
hue	màu sắc
hue	huế
huffed	cáu kỉnh
huge	khổng lồ
hum	ngân nga
humble	khiêm tốn
hummed	ngâm nga
hummorous	hài hước
hundred	hàng trăm
huong	hương
hurray	tiếng hoan hô
hustle	hối hả
hustling	hối hả
hut	túp lều
huu	hữu
huyen	huyền
hyped	hóa
i	tôi
iam	tôi là
ice	nước đá
icecold	đá lạnh
iced	đóng băng
id	tôi
idea	ý tưởng
ideal	lý tưởng
ideas	ý tưởng
ido	tôi làm
idyll	cảnh đồng quê
if	nếu
ifriends	bạn bè
iight	ánh sáng
ill	tôi sẽ
im	tôi
images	hình ảnh
immaculate	vô nhiễm
immaculately	ngay lập tức
immerse	đắm
impeccable	có thể
imperial	thành nội
impersonal	nhân cách
impolite	thô lỗ
importance	tầm quan trọng
important	quan trọng
importantly	quan trọng
impresion	sự ép buộc
impress	gây ấn tượng
impressed	ấn tượng
impression	ấn tượng
impressions	số lần hiển thị
impressive	ấn tượng
improvement	cải tiến
incharge	phụ trách
incheck	trong kiểm tra
incl	bao gồm
include	bao gồm
included	bao gồm
inclus	bao gồm
inconveneicne	sự bất tiện
inconvinience	sự bất tiện
increase	tăng
increasing	tăng
incredible	đáng kinh ngạc
incthe	bên trong
indepence	sự độc lập
indigo	xanh đậm
indochina	đông dương
indoor	trong nhà
infact	trong thực tế
infested	bị lây nhiễm
infinitive	nguyên mẫu
infinity	vô cực
inflatable	bơm hơi
informacion	thông tin
information	thông tin
ingredients	thành phần
initially	ban đầu
inn	quán trọ
inperial	thành nội
insane	điên
insideview	quang cảnh bên trong
insight	cái nhìn sâu sắc
insist	năn nỉ
installation	cài đặt
instructions	hướng dẫn
intercontinal	liên lục địa
intercontinal	xuyên lục địa
intercontinental	xuyên lục địa
intercontinental	liên lục địa
interested	thú vị
interesting	hấp dẫn
international	quốc tế
intrepid	gan dạ
introduce	giới thiệu
introduced	giới thiệu
investigates	điều tra
invoice	hóa đơn
iphone	điện thoại iphone
iris	mống mắt
is	là
island	đảo
issue	vấn đề
istay	tôi ở lại
it	nó
italia	nước ý
item	mục
its	nó là
ivy	cây thường xuân
jaccuzi	bể sục
jaccuzzi	bể sục
jack	giắc cắm
jackfruit	quả mít
jacky	chó rừng
jacuzy	bể sục
jacuzzi	bể sục
jade	ngọc bích
jan	tháng một
janky	vui vẻ
jantle	đùa giỡn
january	tháng giêng
japan	nhật bản
japenese	tiếng nhật
jasmine	hoa nhài
jaunt	đi chơi
jazcuzzi	bể sục
jazz	nhạc jazz
jazzcuzi	bể sục
jeans	quần jean
jenny	cú chọc
jesus	chúa giê-xu
jesus	chúa giêsu
jet	máy bay phản lực
jetstar	sao phản lực
jewel	ngọc
job	việc làm
johny	ạ
jounies	hành trình
journey	hành trình
joy	vui sướng
jubbly	vui mừng
juice	nước ép
jummy	vui vẻ
jun	tháng sáu
junction	giao lộ
june	tháng sáu
jungle	rừng nhiệt đới
junior	trẻ em
just	chỉ
kangaroo	con chuột túi
karma	nghiệp
kayac	thuyền kayac
kayak	chèo xuồng
kayle	thuyền kayle
keep	giữ
keeping	duy trì
keg	thùng
ketchup	sốt cà chua
kettle	ấm đun nước
key	chìa khóa
keycard	thẻ chìa khóa
keyless	không chìa khóa
kha	khà
khao	khao khát
khau	khẩu
khen	khen ngợi
khoai	khoai tây
khoi	khôi
khuong	khương
khuya	đêm nay
khuynh	khuynh hướng
kick	đá
kicked	đá
kictchen	phòng bếp
kid	đứa trẻ
kidclub	câu lạc bộ trẻ em
kidgroup	nhóm trẻ
kids	trẻ em
kidsclub	câu lạc bộ trẻ em
kiem	kiêm
kieu	kiều
killer	sát thủ
killing	giết
kind	tốt bụng
kindly	tử tế
king	nhà vua
kingdom	vương quốc
kingfishers	bói cá
kings	các vị vua
kingsize	cỡ lớn
kinh	dân tộc kinh
kinks	gấp khúc
kit	bộ dụng cụ
kitchen	phòng bếp
kite	cánh diều
kiteboard	ván diều
kiteboending	thả diều
kiting	ăn thịt
kitted	mèo con
kitty	mèo con
kiwi	quả kiwi
know	biết rôi
knowledgeable	có kiến ​​thức
knowlegable	có kiến ​​thức
known	đã biết
koi	cá koi
korea	hàn quốc
kurd	người kurd
lab	phòng thí nghiệm
lackluster	mờ nhạt
lactose	đường lactose
ladies	quý cô
lady	quý bà
ladybird	bọ cánh cam
laf	không có nghĩa
lag	lỗi
lager	bằng lăng
lagoon	đầm phá
lake	hồ nước
lakeside	bờ hồ
lakside	bờ hồ
lama	lạt ma
lame	què
lance	cây thương
land	đất đai
landmark	phong cảnh
landmarket	thị trường nhà đất
landscape	phong cảnh
landscapes	phong cảnh
landscaping	phong cảnh
landscpaes	phong cảnh
lane	làn đường
laneway	làn đường
languange	ngôn ngữ
lantarns	đèn lồng
lantern	đèn lồng
lanterns	đèn lồng
lao	lào
laptop	máy tính xách tay
large	lớn
lasagna	mì nướng kiểu ý
lash	dây da roi
last	cuối cùng
lat	vĩ độ
late	muộn
later	một lát sau
latte	pha cà phê
laudry	giặt ủi
laundry	giặt ủi
laureate	người đoạt giải
laurel	nguyệt quế
lavender	hoa oải hương
lay	đặt nằm
layback	lùi lại
layout	bố trí
layover	trạm dừng chân
laze	ngủ quên
lazing	buồn ngủ
lazy	lười biếng
lcoation	vị trí
lcrthanks	lcr cảm ơn
le	lê
lea	đồng cỏ
lead	chì
leaf	lá cây
leah	nhảy
learge	học hỏi
least	ít nhất
leave	rời khỏi
led	dẫn đầu
led	đèn led
leg	chân
legacy	di sản
legap	cái chân
legend	huyền thoại
legging	quần bó
legit	hợp pháp
leisure	giải trí
lemongrass	cộng sả
lent	cho mượn
leo	sư tử
lerendezvous	điểm hẹn
lesson	bài học
let	để cho
lets	hãy
level	cấp độ
lheritage	di sản
libra	thiên bình
licatiin	vị trí
lie	nói dối
lied	đã nghe
lien	quyền cầm giữ
lieu	thay vì
lieuw	liễuw
life	đời sống
lifeguard	nhân viên cứu hộ
lifetime	cả đời
light	ánh sáng
lightly	nhẹ nhàng
lightning	tia chớp
lights	đèn
lighttube	ống đèn
like	thích
liker	người nói dối
lilac	tử đinh hương
lilly	hoa loa kèn
lily	hoa loa kèn
lilys	hoa huệ
limestone	đá vôi
line	hàng
linens	khăn trải giường
link	liên kết
list	danh sách
lit	thắp sáng
lite	đọc nhẹ
literie	người biết chữ
litter	xả rác
litters	lứa
little	ít
liu	liu điu
live	trực tiếp
livelier	sống động hơn
living	cuộc sống
lluggage	hành lý
loa	ổ bánh mì
loacation	vị trí
loads	tải
loan	tiền vay
lobby	sảnh đợi
lobbybar	quầy bar ở sảnh
lobster	tôm
loc	lộc
local	địa phương
locals	người dân địa phương
located	nằm
locatiin	vị trí
locatiom	địa điểm
locatiom	vị trí
location	vị trí
locations	địa điểm
locatoion	vị trí
lock	khóa
locked	bị khóa
locker	khóa
loctaion	vị trí
lodge	lều
loft	căn hộ nhỏ
log	nhật ký
logic	hợp lý
lokation	chỗ ở
loking	đang nhìn
lol	cười lớn
lolation	cách ly
lonely	cô đơn
long	dài
look	nhìn
looked	đã nhìn
looker	người nhìn
looking	đang nhìn
lookwise	nhìn kỹ
loop	vòng
loope	dây buộc
lords	lãnh chúa
lost	mất đi
lot	nhiều
lots	rất nhiều
lotus	rất nhiều
loudly	ầm ĩ
loug	lười biếng
lougne	phòng chờ
lougnge	phòng chờ
loundry	giặt ủi
lounge	phòng chờ
love	yêu và quý
loved	yêu
lovely	đáng yêu
loves	yêu
loving	thương
loyality	trung thành
luan	luân
luck	may mắn
lucky	may mắn
luggage	hành lý
lugggae	hành lý
lullaby	hát ru
lum	tùm lum
luminous	sáng
luna	ánh trăng
lunar	mặt trăng
lunch	bữa trưa
lung	phổi
luong	luồng
luv	yêu
luxery	xa xỉ
luxury	sang trọng
luxuy	sang trọng
lying	nói dối
machine	máy móc
mad	điên
made	thực hiện
magical	huyền diệu
magnolia	mộc lan
mail	thư
main	chủ yếu
maintainace	bảo trì
majestic	hùng vĩ
majetstic	chuyên ngành
makes	làm cho
makeup	trang điểm
makong	chế tạo
malay	tiếng mã lai
mam	mẹ
mama	má
man	đàn ông
manage	quản lý
managed	quản lý
manager	giám đốc
maneger	người điều khiển
manger	máng cỏ
manky	lưu manh
manor	trang viên
many	nhiều
map	bản đồ
maple	cây phong
mapping	lập bản đồ
maps	bản đồ
marigold	cúc vạn thọ
marina	bến du thuyền
marine	hàng hải
mark	dấu
markdown	đánh dấu
marker	đánh dấu
market	thị trường
marketing	tiếp thị
markets	thị trường
martket	thị trường
marts	siêu thị
marvel	kỳ quan
marvelous	kỳ diệu
marvrllous	kỳ diệu
mass	khối lượng
massage	mát xa
massager	máy mát xa
masseur	người xoa bóp
masseuses	mát xa
massge	mát xa
massshe	mát xa
mast	cột buồm
master	bậc thầy
masterstroke	cột buồm
mastic	gắn gương
mat	chiếu
matday	ngày tháng năm
mate	người bạn đời
matraces	ma trận
matress	nệm
matresses	nệm
matsa	thảma
maverlous	kỳ diệu
max	tối đa
maxim	châm ngôn
mbps	mb / giây
me	tôi
meal	bữa ăn
meals	bữa ăn
meatball	thịt viên
medallion	huy chương
media	phương tiện truyền thông
mediocre	tầm thường
meesting	yêu cầu
meet	gặp
meeting	gặp gỡ
mega	siêu cấp
megamall	trung tâm thương mại lớn
melody	làn điệu
member	thành viên
members	các thành viên
memorable	đáng nhớ
memories	kỉ niệm
memority	thâm niên
memory	ký ức
men	đàn ông
menu	thực đơn
mercure	thương xót
mercury	thủy ngân
merit	n: xứng đáng
merrily	vui vẻ
mess	lộn xộn
message	thông điệp
messages	tin nhắn
messenger	tin nhắn
met	gặp
metro	tàu điện
mgr	đức cha
micro	vi mô
microfiber	sợi vải
microphone	cái mic cờ rô
microwave	lò vi sóng
middle	ở giữa
migra	di cư
mihouse	nhà của mi
mildew	nấm mốc
mile	dặm
milk	sữa
milkyway	dải ngân hà
minded	đầu óc
mineral	khoáng sản
miniature	thu nhỏ
minibus	xe buýt nhỏ
minifridge	tủ lạnh nhỏ
minimart	siêu thị nhỏ
minimarts	siêu thị nhỏ
minor	diễn viên phụ
mins	phút
mint	cây bạc hà
minus	dấu trừ
minuses	số phút
minusside	điểm trừ
minute	phút
minutes	phút
miss	cô
missall	bỏ lỡ tất cả
missing	còn thiếu
mistake	sai lầm
mistakes	những sai lầm
mister	quí ông
mix	pha trộn
mixologist	người pha trộn
moan	kêu van
modern	hiện đại
modernization	hiện đại hóa
moldy	bị mốc
mom	mẹ
moment	chốc lát
moments	khoảnh khắc
mon	thứ hai
money	tiền bạc
moneys	tiền
monkey	con khỉ
monsieur	ngài
month	tháng
months	tháng
mood	tâm trạng
moody	buồn rầu
moon	mặt trăng
moonlight	ánh trăng
moonrise	mặt trăng
moons	mặt trăng
moove	di chuyển
mopds	cây lau nhà
mopeds	xe gắn máy
more	hơn
morning	buổi sáng
mosquito	con muỗi
mosquitoes	muỗi
mosquitos	muỗi
most	phần lớn
motel	nhà trọ
mother	mẹ
motobike	xe máy
motobikes	xe máy
motor	động cơ
motorbike	xe máy
motorcycle	xe máy
motorcycles	xe máy
mouldy	bị mốc
mountain	núi
mountan	núi
mouse	chuột
mousquitos	muỗi
moutain	núi
mouth	mồm
mouthwatering	vừa miệng
move	di chuyển
moved	đã di chuyển
mr	ông
mrs	bà
mtr	triệu
much	nhiều
muck	vấy bẩn
mugs	cốc
muine	mũi tên
mumma	mẹ
mummas	mẹ
muse	ngân nga
mushroom	nấm
music	âm nhạc
musky	xạ hương
muslim	hồi
must	phải
mustgo	phải đi
mutiple	bội số
my	của tôi
mystery	huyền bí
myth	thần thoại
mytuor	gia sư của tôi
mytv	tv của tôi
myvillage	làng tôi
nachos	bánh nachos
nacks	ngủ trưa
nail	móng tay
name	tên
named	được đặt tên
nasties	tuổi mới lớn
nastiest	xấu nhất
nationalpark	công viên quốc gia
natural	tự nhiên
nature	thiên nhiên
navy	hải quân
near	ở gần
necrotizing	hoại tử
need	nhu cầu
needs	nhu cầu
neighboor	hàng xóm
neighboors	người hàng xóm
neighter	người cận thị
neon	đèn neon
nerver	thần kinh
net	mạng lưới
never	không bao giờ
neverland	vùng đất thần thoại
new	mới
newish	mới mẻ
newly	mới
news	tin tức
newway	cách mới
next	kế tiếp
nextdoor	cánh cửa tiếp theo
ngai	ngãi
ngan	ngân
nghe	nghệ
nghiem	nghiêm
ngo	ngô
ngoai	ngoại
ngoc	ngọc
ngonthanks	ngoncảm ơn
nguyen	nguyên
nguyen	nguyễn
ngyugen	nguyên
nham	nhâm
nheo	nheo nhóc
nhit	nhắng nhít
nhon	nhơn
nhut	nhựt
nice	đẹp
niceee	tốt đẹp
nicely	độc đáo
niggle	cười đùa
night	đêm
nightbus	xe buýt đêm
nightcap	mũ ngủ
nightlife	cuộc sống về đêm
nightmare	ác mộng
nightmarket	chợ đêm
nights	đêm
nightthe	ban đêm
nigth	đêm
nigts	đêm
nine	chín
nirvana	niết bàn
nite	đêm
no	không
noboby	không ai
nobody	không ai
noddles	gật gù
noi	không có i
noise	tiếng ồn
noisebed	giường ồn ào
noisey	ồn ào
nom	nôm na
nomad	du mục
nomadder	nôm na
non	không
nonchalant	hờ hững
nontheless	dù sao thì
nooddle	bún
noodle	bún
normal	bình thường
north	bắc
nostalgia	hoài cổ
not	không
notch	khía
nothing	không có gì
notice	để ý
notre	dấu vết
noudles	mì
nov	tháng 11
now	hiện nay
number	con số
numberone	số một
nutella	bơm
nuygen	nguyên
oaks	cây sồi
oakwood	gỗ sồi
oasis	ốc đảo
oberwatch	ghi đè
obliging	nghĩa vụ
occopancy	chiếm dụng
oceam	đại dương
ocean	đại dương
oceanview	đại dương
ocidental	tình cờ
oct	tháng 10
of	của
ofas	như là
ofcoz	tất nhiên
off	tắt
offered	cung cấp
office	văn phòng
official	chính thức
offputting	đặt ra
offsite	ngoại vi
ok	ổn
okay	được chứ
okthank	được rồi, cảm ơn
old	cũ
olde	người già
oldies	người già
oldtown	phố cổ
olive	ôliu
omeletes	trứng tráng
omelett	trứng tráng
omelette	ốp lết
omelettes	trứng tráng
omeletts	trứng tráng
omg	chúa ơi
omlets	ốp lết
omlette	ốp lết
omletter	ốp lết
on	trên
once	một lần
one	một
ones	những cái
onetrip	một chuyến đi
online	trực tuyến
only	chỉ có
onsen	suối nước nóng
ooops	rất tiếc
oops	giáo sư
open	mở
openning	mở ra
operation	hoạt động
opertunity	dịp tốt
opion	ý kiến
opportunity	dịp tốt
opption	sự chống đối
option	lựa chọn
options	tùy chọn
orange	trái cam
orat	hoặc tại
orchidees	tinh hoàn
order	đặt hàng
ordered	đã đặt hàng
oreint	định hướng
organic	hữu cơ
oriced	có giá cao
oriental	phương đông
original	nguyên
other	khác
others	khác
our	của chúng tôi
ourguide	hướng dẫn của chúng tôi
ourself	chính chúng ta
ourselves	chính chúng ta
oustanding	nổi bật
out	ngoài
outdoor	ngoài trời
outing	đi chơi xa
outlet	lối thoát
outside	ở ngoài
outstandig	nổi bật
outstanding	nổi bật
outstandingly	xuất sắc
outting	đi chơi
outweighed	vượt trội hơn
ov	noãn
oven	lò
over	kết thúc
overal	nói quá
overall	nhìn chung
overalla	quần yếm
overbooked	đặt trước quá nhiều
overcharged	quá mức
overlord	bá vương
overnighter	quá sức
overnigth	qua đêm
overpriced	định giá quá cao
overprized	quá nhiều
overrated	đánh giá quá cao
oversize	khích thước lớn
overwater	trên mặt nước
overwelmed	choáng ngợp
owers	chủ nợ
own	sở hữu
owner	chủ nhân
ownermanager	quản lý chủ sở hữu
owners	những chủ sở hữu
owns	sở hữu
ownwer	chủ nhân
pa	bố
pacakaged	đóng gói
pacific	thái bình dương
package	gói
package	gói hàng
packbacker	tây ba lô
packeges	gói hàng
packers	người đóng gói
pad	tập giấy
paddy	thóc
pain	đau đớn
palace	cung điện
palm	lòng bàn tay
pan	cái chảo
pancake	bánh kếp
pancakes	bánh xèo
pandan	lá dứa
pankcakes	bánh xèo
panorama	toàn cảnh
papaya	đu đủ
papermap	bản đồ giấy
paperthin	giấy mỏng
par	ngang bằng
paracel	hoàng sa
paradise	thiên đường
paramount	tối quan trọng
parasailing	nhảy dù
parc	bưu kiện
pardise	thiên đường
pariat	ban giám hiệu
park	công viên
part	phần
particulares	chi tiết
partier	người chia tay
partner	cộng sự
party	buổi tiệc
partys	vợ chồng
pasports	hộ chiếu
pass	vượt qua
passion	niềm đam mê
passionfruit	chanh dây
passport	hộ chiếu
passports	hướng dẫn
pasta	mỳ ống
pastel	màu phấn
pasword	mật khẩu
pat	vỗ nhẹ
path	con đường
patien	kiên nhẫn
patio	sân trong
pationate	gỉ sắt
pavilion	gian hàng
pay	trả
paying	trả tiền
peace	sự thanh bình
peaceful	bình yên
peacful	bình yên
peach	đào
peanut	đậu phụng
peapole	mọi người
pear	lê
pearl	ngọc trai
pebble	đá cuội
peddling	bán rong
pedestrian	người đi bộ
peep	nhìn trộm
peeps	nhìn trộm
pefect	hoàn hảo
peking	bắc kinh
pen	cây bút
penh	pênh
peninsula	bán đảo
penny	đồng xu
penthouse	căn hộ áp mái
people	mọi người
peoples	dân tộc
pepper	tiêu
percent	phần trăm
perfecly	hoàn hảo
perfect	hoàn hảo
perferct	hoàn hảo
perfume	nước hoa
perk	thù lao thêm
perle	lần
person	người
persona	cá tính
personable	dễ thương
personas	cá tính
personell	nhân viên
personnel	nhân viên
perssonnel	nhân viên
perverts	những kẻ biến thái
pesonally	cá nhân
pet	vật nuôi
petite	nhỏ
phai	phái
pho	phở
phoenix	phượng hoàng
phone	điện thoại
phonecall	gọi điện
phones	những cái điện thoại
photo	tấm ảnh
photobombing	ghép ảnh
photos	ảnh chụp
photoshopper	người chụp ảnh
phu	phú
phuc	phúc
phuong	phương
pi	số pi
pianist	nghệ sĩ piano
piano	đàn piano
pick	hái
pickering	hái lượm
pickup	nhặt lên
picnic	đi chơi picnic
pics	bức ảnh
pictures	những bức ảnh
piizzas	bánh pizza
pillow	cái gối
pine	cây thông
pines	cây thông
pingpong	bóng bàn
pink	hồng
pinnut	hạt dẻ
pisatchio	hạt dẻ cười
pistachio	hạt dẻ cười
pitch	sân cỏ
pitty	hầm hố
plac	người khác
place	địa điểm
places	nơi
placesurely	địa điểm
plan	kế hoạch
planet	hành tinh
planner	người lập kế hoạch
plantation	đồn điền
plase	làm ơn
plasters	trát tường
plastic	nhựa dẻo
plat	tấm ván
platfrorm	nền tảng
platinum	bạch kim
playlist	danh sách phát
plaza	quảng trường
pleasant	hài lòng
please	xin vui lòng
pleasure	vui lòng
plek	cầu xin
plesant	khó chịu
plowman	thợ cày
plugin	cắm vào
plum	mận
plus	thêm
pm	buổi chiều
pocky	có gai
pod	vỏ quả
poem	bài thơ
pohled	phập phồng
point	điểm
points	điểm
police	cảnh sát
polite	lịch sự
pomelos	bưởi
pool	hồ bơi
pool	bể bơi
poolbar	bể bơi
poolside	bên hồ bơi
pooltable	hồ bơi
poond	trầm ngâm
poor	tệ
pop	bật ra
popped	xuất hiện
popping	bốp
populars	bình dân
population	dân số
porch	hiên nhà
pork	thịt heo
port	hải cảng
portly	đẹp đẽ
posh	sang trọng
poshtel	sang trọng
positifs	dương tính
position	chức vụ
positives	tích cực
post	bài đăng
postoffice	bưu điện
powerpoints	điểm mạnh
ppl	mọi người
prace	lời chúc tụng
practice	thực hành
prder	đặt hàng
prebooked	đặt trước
precious	quí
prefabricados	nhà tiền chế
premier	đứng đầu
premium	cao cấp
prepare	chuẩn bị
prepping	sơ chế
present	hiện tại
press	nhấn
pretty	đẹp
previous	trước
price	giá bán
pricerange	phạm vi giá
pricier	đắt hơn
pricy	quý giá
prime	nguyên tố
primer	lót
prince	hoàng tử
princess	công chúa
prior	trước
prior	ưu tiên
prises	mồi
private	riêng tư
privet	mồi
pro	chuyên nghiệp
proactively	chủ động
probably	có lẽ
problem	vấn đề
profasional	chuyên nghiệp
profesionnal	chuyên nghiệp
professional	chuyên nghiệp
professionalism	sự chuyên nghiệp
professionnalisme	nghề nghiệp
proffesional	chuyên nghiệp
progressive	cấp tiến
promenades	lối đi dạo
promissed	đã hứa
promo	quảng cáo
propper	thợ săn
prorate	chia theo tỷ lệ
pros	ưu điểm
protein	chất đạm
prove	chứng minh
province	tỉnh
pruce	cắt tỉa
ptoperty	bất động sản
pub	quán rượu
pubbar	quán rượu
pubes	quán rượu
public	công cộng
pudding	bánh pudding
puking	nôn mửa
pullman	người kéo
pullup	kéo lên
pumpkin	quả bí ngô
punctuality	đúng giờ
puolet	màu tím
puplic	công cộng
puppies	bố cục
purpose	mục đích
pusan	xô đẩy
pushy	tự đề cao
put	đặt
quac	quắc
quadruple	bốn người
quaint	cổ kính
qualities	phẩm chất
quality	chất lượng
quan	quân
quanh	quánh
quanhtuy	quánh
quarte	cãi nhau
quarter	phần tư
quartier	người khai hoang
quat	quất
quaters	người xếp hạng
que	xếp hàng
queen	nữ hoàng
queensize	cỡ lớn
quen	dập tắt
quest	nhiệm vụ
question	câu hỏi
quieres	run rẩy
quiet	yên tĩnh
quirky	kỳ quặc
quit	thoát
quite	khá
quitely	chuyên tâm
quiteness	sự yên tĩnh
quoc	quốc
quots	dấu ngoặc kép
quyen	quyên
quynh	quỳnh
raccomend	gợi ý
race	cuộc đua
radio	đài
rag	giẻ
rain	mưa
rainbow	cầu vồng
raining	mưa
raintime	thời gian raintime
raked	cào
ran	đã chạy
rang	reo lên
ranh	ranh giới
rank	cấp
rarely	ít khi
raspberry	dâu rừng
rat	con chuột
ratats	chuột cống
rate	tỷ lệ
rates	giá
rati	tỷ lệ
ratng	xếp hạng
rats	chuột cống
ratt	tiếng lục lạc
rattled	lạch cạch
raving	say sưa
ray	cá đuối
re	lại
reaction	phản ứng
read	đọc
reading	đọc hiểu
realized	nhận ra
reallly	có thật không
really	có thật không
reason	lý do
reasonable	hợp lý
reastaurants	nhà hàng
reastaurnt	nhà hàng
reataurant	nhà hàng
recastion	tuyển dụng
reccomend	đề nghị
reccomendation	sự giới thiệu
reccommend	đề nghị
reccommended	đề nghị
receipt	biên lai
received	nhận
recepcion	sự tiếp thu
receprptionist	lễ tân
recept	chấp nhận
receptie	người nhận
reception	tiếp nhận
reception	lễ tân
receptionist	lễ tân
receptionists	lễ tân
recepton	thụ thể
recetionist	lễ tân
recidence	nơi cư trú
recieptionist	lễ tân
recipient	người nhận
recliners	ghế tựa
recomend	gợi ý
recomendation	sự giới thiệu
recomended	đề nghị
recoment	giới thiệu
recomentded	đề nghị
recommand	lời nhắc nhở
recommanded	đề nghị
recommdable	đáng tin cậy
recommed	gợi ý
recommend	giới thiệu
recommendation	sự giới thiệu
recommended	đề nghị
recommendso	giới thiệu
recommened	đề nghị
recommented	đề nghị
recommnend	gợi ý
reconfirm	xác nhận lại
records	hồ sơ
red	đỏ
redcommend	tuyên dương
redecoration	trang trí lại
redhouse	ngôi nhà màu đỏ
redicilous	nực cười
redoing	làm lại
redy	đỏ tía
reed	cây lau
ref	tham khảo
refill	đổ đầy
refresh	làm tươi
refrigerator	tủ lạnh
refshuffled	nhồi lại
regal	quốc vương
regard	sự quan tâm
regards	trân trọng
regency	nhiếp chính
regional	khu vực
reivew	ôn tập
relation	quan hệ
relationship	mối quan hệ
relax	thư giãn
relaxation	thư giãn
relaxed	thư thái
relaxing	thư giãn
remants	tàn dư
rememberable	có thể nhớ được
remode	làm lại
remote	xa xôi
renaissance	thời phục hưng
rendezuvous	điểm hẹn
rendezvous	điểm hẹn
rent	thuê
reort	sắp xếp lại
reosrt	phương sách
rep	đại diện
repair	sửa
repeated	lặp đi lặp lại
replace	thay thế
replaced	thay thế
reply	đáp lại
reprieve	ân hận
request	yêu cầu
rersort	phương sách
resault	cướp lại
reseption	tiếp nhận
reservation	dự phòng
reset	cài lại
residence	nơi cư trú
residences	cư xá
residences	khu dân cư
residencia	cư xá
resident	cư dân
resoer	phương sách
resoet	phương sách
resor	người bán lại
resort	phương sách
resorted	nghỉ dưỡng
resorts	khu nghỉ dưỡng
resot	tiếng vang
resp	đáp lại
resport	hô hấp
resraurants	nhà hàng
resraurent	nhà hàng
resrost	nối lại
resrot	phương sách
resrt	phương sách
resrurant	nhà hàng
rest	nghỉ ngơi
restaraunt	nhà hàng
restaruants	nhà hàng
restarunt	nhà hàng
restaunt	nhà hàng
restaurang	nhà hàng
restaurant	nhà hàng
restaurants	các nhà hàng
restaurants	nhà hàng
resteraunt	nhà hàng
resteraunts	nhà hàng
restoran	phục hồi
restos	nghỉ ngơi
restraunt	nhà hàng
restroom	phòng vệ sinh
restrurant	nhà hàng
restuarants	nhà hàng
resturant	nhà hàng
restyling	nghỉ ngơi
retreat	rút lui
retro	cổ điển
rette	nói lại
returning	trở về
review	nhận xét
reviews	đánh giá
revirew	ôn tập
revisited	đã duyệt lại
rew	phần thưởng
rice	cơm
ricefield	ruộng lúa
riceflower	hoa gạo
ricewine	rượu gạo
rickety	ọp ẹp
riddled	câu đố
rides	cưỡi ngựa
ridiculously	nực cười
righ	đúng
rightly	đúng
rim	vành
rip	yên nghỉ
rise	tăng lên
risemount	tăng lên
risemount	số tiền rủi ro
riser	ống đứng
rising	trỗi dậy
river	con sông
riverfront	bờ sông
riverlife	cuộc sống trên sông
riverside	ven sông
riversive	sông
riverwalk	đường ven sông
road	đường
robes	áo choàng
robot	người máy
rock	đá
rockclimbing	leo núi
rockhard	đá cứng
rocks	đá
roftop	sân thượng
rogue	giả mạo
rolls	bánh cuốn
romance	lãng mạn
romance	tình cảm
romantic	lãng mạn
romms	lãng mạn
roof	mái nhà
roofbar	thanh mái
rooftop	sân thượng
room	phòng
roomgreat	phòng lớn
roomie	phòng trọ
rooming	phòng trọ
rooms	phòng
roomsbeachpool	phòng tắm
roomservice	dịch vụ phòng
rooptop	sân thượng
rooster	gà trống
root	nguồn gốc
ropey	dây thừng
rose	hoa hồng
rosemarry	cây mê điệt
rosemary	cây mê điệt
roses	hoa hồng
rot	thúi
rottening	thối rữa
rough	thô
roulette	cò quay
roundtrip	khứ hồi
router	bộ định tuyến
royal	hoàng gia
royality	hoàng gia
rrats	chúc mừng
ruby	hồng ngọc
rude	thô lỗ
rudest	thô lỗ
run	chạy
rural	nông thôn
russian	tiếng nga
russiana	tiếng nga
rustic	mộc mạc
sac	túi
sad	buồn
sadly	thật đáng buồn
safary	an toàn
safe	an toàn
safebox	két sắt
safety	sự an toàn
sage	hiền nhân
said	nói
saigon	sài gòn
sailing	thuyền buồm
sailinh	thuyền buồm
sakura	hoa anh đào
salad	rau xà lách
salamanders	kỳ nhông
sale	giảm giá
sales	bán hàng
salon	thẩm mỹ viện
salsa	điệu salsa
salt	muối
salvation	sự cứu rỗi
sanatized	làm vệ sinh
sanctuary	thánh địa
sand	cát
sands	cát
sandwich	bánh mì sandwich
sandwitch	bánh mì kẹp
sanitair	nhà vệ sinh
sanitiser	chất tẩy rửa
sank	chìm
santa	ông già noel
saparate	tách rời
sat	đã ngồi
satifying	hài lòng
satisfied	hài lòng
satissfied	hài lòng
sattelite	vệ tinh
satyed	đã ở lại
sauna	tắm hơi
saves	tiết kiệm
say	nói
scam	lừa đảo
scaming	lừa đảo
scammed	bị lừa đảo
scammer	kẻ lừa đảo
scamming	lừa đảo
scams	lừa đảo
scandinavi	bán đảo scandinavia
scandinavia	bán đảo scandinavia
scape	vật tế thần
scarlet	đỏ tươi
scarrings	vết sẹo
scene	bối cảnh
scenery	phong cảnh
scenic	phong cảnh
sceond	thứ hai
scootering	loang lổ
scramble	tranh giành
screaming	la hét
screeches	tiếng rít
screeching	rít lên
screen	màn
scruffy	nhăn nhó
sea	biển
seacond	tàu biển
seafront	bờ biển
seagull	hải âu
seahors	cá ngựa
seahorse	cá ngựa
seahose	cá ngựa
sealink	con dấu
seasde	bờ biển
seashell	vỏ sò
seashells	vỏ sò
seashore	bờ biển
seaside	bờ biển
seasons	các mùa
seastar	sao biển
seat	ghế
seaview	hướng biển
seaweed	rong biển
second	thứ hai
secure	đảm bảo
security	bảo vệ
seedy	có nhiều hạt
seeview	ngăm cảnh
select	lựa chọn
selected	đã chọn
self	bản thân
selfie	chụp ảnh tự sướng
selfies	ảnh tự chụp
semaines	học kỳ
seminar	hội thảo
sencerity	sự chân thành
sended	đã gửi
sense	giác quan
senses	giác quan
sent	gởi
sentir	lính gác
sep	tháng chín
sepia	màu nâu đỏ
sera	huyết thanh
serenade	dạ khúc
serenaded	theo dõi
serene	thanh thản
serenity	thanh thản
serioulsly	nghiêm túc
serious	nghiêm trọng
served	phục vụ
server	người phục vụ
servic	dịch vụ
service	dịch vụ
servicea	dịch vụ
serviced	phục vụ
serviceman	người phục vụ
services	dịch vụ
serviec	dịch vụ
servives	dịch vụ
sesame	mè
set	bộ
setup	thiết lập
setvice	dịch vụ
several	một số
sevices	thiết bị
sex	tình dục
sgranate	quả lựu
shabby	tồi tàn
shack	lán
shade	bóng râm
shampoo	dầu gội đầu
shape	hình dạng
sharing	chia sẻ
shark	cá mập
she	bà ấy
shearing	cắt xén
sheet	tấm
sheets	tờ giấy
sheets	trang tính
shell	vỏ
shell	vỏ sò
shelter	nơi trú ẩn
shenanigans	tai quái
shhhhh	suỵt
shining	sáng
ship	giao hàng
shipper	người giao hàng
shirt	áo sơ mi
shit	tệ
shittier	dở hơi
shock	sốc
shop	cửa hàng
shop	cửa tiệm
shopaholics	người nghiện mua sắm
shopee	ứng dụng
shopping	mua sắm
shoppingtour	đi du lịch mua sắm
shops	cửa hàng
short	ngắn
shorting	rút ngắn
shot	bắn
shoutout	la lên
show	chỉ
shower	vòi sen
showing	hiển thị
shrims	tôm
shuttle	đưa đón
siagon	sài gòn
side	bên
sideroad	lề đường
siesta	giấc ngủ trưa
siesta	ngủ trưa
sigarette	thuốc lá
sightseeings	điểm tham quan
signature	chữ ký
signposted	biển chỉ dẫn
silence	im lặng
silent	im lặng
silk	lụa
silkpath	con đường tơ lụa
silver	bạc
simcard	thẻ sim
simoly	đơn giản
simple	đơn giản
simplicity	sự đơn giản
simply	đơn giản
sin	tội
since	từ
singer	ca sĩ
singing	ca hát
single	độc thân
sinserely	trân trọng
sister	em gái
sisters	chị em gái
site	địa điểm
sitetour	tour du lịch trang web
sitting	ngồi
six	sáu
size	kích cỡ
size	kích thước
sized	kích thước
skate	giày trượt băng
skewers	xiên que
skilled	có tay nghề cao
sky	bầu trời
skylight	giếng trời
skyline	đường chân trời
skylit	bầu trời
skylounge	phòng chờ bay
skype	ứng dụng trò chuyện
skyping	bay lên
slags	đồ ăn mòn
sleep	ngủ
slice	lát
sligthly	nhẹ nhàng
sling	treo lên
slings	cáp treo
slippery	trơn
slippy	trơn trượt
smack	đập
smacked	đánh lén
small	nhỏ
smart	thông minh
smarttv	tv thông minh
smartwach	đồng hồ thông minh
smashburger	bánh mì kẹp thịt
smel	luyện kim
smell	mùi
smelling	ngửi
smelly	hôi
smelt	thơm
smile	nụ cười
smiles	nụ cười
smiling	mỉm cười
smith	thợ rèn
smmel	cười khẩy
smoke	khói
smoking	hút thuốc
smoothie	sinh tố
smoothies	sinh tố
smothie	sinh tố
smothies	bánh kẹo
smudgy	nhòe nhoẹt
snail	ốc sên
snapper	cá hồng
sniff	bị nghẹt mũi
sniper	kẻ bắn tỉa
snorkel	ống thở
snorkeling	lặn với ống thở
snorkelling	lặn với ống thở
snotty	lém lỉnh
snow	tuyết
snowy	có tuyết rơi
snuck	lẻn
snug	ấm áp
soakers	người làm bánh
soap	xà bông
soccer	bóng đá
social	xã hội
socola	sô cô la
sofa	ghế sô pha
soft	mềm mại
sohotel	khách sạn
solarsystem	hệ mặt trời
soldier	lính
soleil	đế giày
soleil	đất
solo	đấu
some	một số
somerset	bộ quần áo
something	cái gì đó
something	ngươi
somethings	một số điều
somewhen	lúc nào đó
somtime	thỉnh thoảng
song	bài hát
sont	không
soon	sớm
soonest	sớm nhất
sorry	lấy làm tiếc
soso	tam tạm
soul	linh hồn
sound	âm thanh
soup	súp
south	miền nam
souvenier	vật lưu niệm
souvenir	quà lưu niệm
sower	người gieo giống
space	không gian
spaceous	rộng rãi
spaces	dấu cách
spacieuse	khoảng trống
spacious	rộng rãi
spaciuos	rộng rãi
spaghetti	mì ống ý
span	nhịp
sparklingly	lấp lánh
speacial	đặc biệt
special	đặc biệt
specially	đặc biệt
specials	đặc biệt
spent	bỏ ra
spesk	nói
spice	gia vị
spicy	vị cay
spider	con nhện
splendid	lộng lẫy
splurge	bắn tung toé
spoiler	làm hư hỏng
spoons	thìa
sport	thể thao
sports	các môn thể thao
spot	nơi
spotless	không tì vết
spotlessley	không tì vết
spread	lây lan
spring	mùa xuân
springrolls	chả giò
springs	lò xo
spy	gián điệp
squalid	có vảy
square	quảng trường
squeaky	kêu cót két
squid	mực ống
squished	nhăn nheo
sraff	con quỷ
staben	đâm vào
stacious	ngoan cố
staff	nhân viên
staffs	nhân viên
stairwell	cầu thang
stanards	tiêu chuẩn
standar	độc lập
standard	tiêu chuẩn
stank	hôi thối
stank	ngân hàng
staps	đinh ghim
star	ngôi sao
starcity	sự khan hiếm
starfruit	trái khế
stark	ngay đơ
starlight	ánh sao
stars	các ngôi sao
start	khởi đầu
stat	chỉ số
station	ga tàu
stationall	trạm
statt	trạng thái
stay	ở lại
stayed	đã ở lại
stayed	ở lại
stayin	ở lại
staying	ở lại
steak	miếng bò hầm
steal	lấy trộm
steam	hơi nước
steambath	tắm hơi
stel	tấm bia
stellar	thuộc về sao
stick	gậy
stile	cứng nhắc
sting	châm chích
stinks	bốc mùi
stinks	liên kết
stints	tiền lương
stoipped	bị đánh cắp
stolen	ăn cắp
stop	dừng lại
stopover	dừng chân
store	cửa hàng
stors	cửa hàng
story	câu chuyện
straff	lải nhải
straight	thẳng
strange	kỳ lạ
stranger	người lạ
stranger	người cướp
strawhat	mũ rơm
strees	nhấn mạnh
street	đường phố
streets	đường phố
stress	nhấn mạnh
stressful	căng thẳng
strike	đình công
strip	dải
strong	mạnh
strongly	mạnh mẽ
stronly	mạnh mẽ
stuff	đồ đạc
stuffs	chất liệu
stumbled	vấp ngã
stunning	kinh ngạc
stupid	ngốc nghếch
style	phong cách
styles	phong cách
stylist	nhà tạo mẫu
suburban	ngoại ô
successful	thành công
successfully	thành công
sucessfull	thành công
such	như là
sue	kiện
sufing	lướt ván
suggest	đề xuất
suit	bộ đồ
suitable	thích hợp
suite	thượng hạng
suiting	kiện cáo
sum	tổng
summer	mùa hè
sun	mặt trời
sunbed	nằm phơi nắng
sunbeds	giường tắm nắng
sunchair	ghế tắm nắng
sunday	chủ nhật
sunflower	hoa hướng dương
sunlake	bông nắng
sunland	vùng đất mặt trời
sunlight	ánh nắng mặt trời
sunline	dải nắng
sunloungers	ghế tắm nắng
sunny	nắng
sunrise	bình minh
sunsea	hoàng hôn
sunset	hoàng hôn
sunshine	ánh sáng mặt trời
sunway	đường đi nắng
suong	sương
super	siêu
superb	tuyệt vời
supercheap	siêu rẻ
superfresh	siêu tươi
superior	cấp trên
supernice	tuyệt đẹp
superseeds	hạt siêu
supervior	người giám sát
supervisor	người giám sát
supper	bữa tối
supperior	cấp trên
support	ủng hộ
supposed	được cho là
supprise	cung cấp
suprise	ngạc nhiên
suraunded	ngập tràn
sure	chắc chắn rồi
surely	chắc chắn
surfingwinds	lướt sóng
surfshop	cửa hàng lướt sóng
surise	bình minh
surly	đột ngột
surperior	cấp trên
surprise	sự ngạc nhiên
surrounded	được bao quanh
survice	phụ tá
suspendre	dây treo
suttle	kinh sư
swan	thiên nga
swarm	họp lại
sweat	mồ hôi
sweet	ngọt
sweethouse	căn nhà dễ thương
swim	bơi
swiming	bơi lội
swimingpool	hồ bơi
swimming	bơi lội
swimsuits	đồ bơi
swindled	lừa dối
swipe	vuốt
swiss	thụy sĩ
switch	công tắc điện
switches	chuyển đổi
swooping	sà vào
sympatyczni	giao cảm
syrup	xi-rô
tab	chuyển hướng
tables	những cái bàn
tacky	dính chặt
tacos	bánh tét
tailor	thợ may
tailormade	may rủi
taiwan	đài loan
take	lấy
takeaway	lấy đi
takecare	bảo trọng
takes	nhận
talk	nói chuyện
talkies	người nói chuyện
tamarind	quả me
tan	rám nắng
tanh	tánh
tanning	thuộc da
tap	gõ nhẹ
tap	nhấn vào
tarik	thuế quan
tasteless	tệ
tasty	ngon
tatashow	chiếu tatashow
tatsy	ướt át
tatto	hình xăm
tattoo	xăm hình
tatty	rách nát
taxi	xe tắc xi
taximeter	máy đo thuế
tea	trà
teabreak	tiệc trà
team	đội
teambuiding	xây dựng nhóm
teambuiding	xây dựng đội ngũ
teansfer	chuyển khoản
teatching	giảng bài
technology	công nghệ
teen	tuổi teen
teeup	thiếu niên
teiple	gấp ba
tele	điện báo
tell	nói
telling	nói
telly	truyền hình
temple	ngôi đền
templing	cám dỗ
temptation	sự cám dỗ
ten	mười
tennis	quần vợt
tequila	rượu tequila
teracotta	đất nung
terible	khó khăn
termina	chấm dứt
terms	điều kiện
terra	ruộng bậc thang
terrace	sân thượng
terraces	sân thượng
terracotta	đất nung
terrible	khủng khiếp
terrific	khủng khiếp
test	kiểm tra
tet	ngày tết
tgeir	của chúng
tguong	thường
th	thứ tự
thai	thái
than	hơn
thang	thắng
thank	cảm tạ
thank you	cảm ơn
thanks	cảm ơn
thankyou	cảm ơn bạn
that	cái đó
thats	đó là
the	các
theif	kẻ trộm
their	của chúng
theives	kẻ trộm
them	chúng
them	họ
theme	chủ đề
thenhin	sau đó
therapist	nhà trị liệu
therapit	nhà trị liệu
there	ở đó
there	đó
theres	ở đó
thers	của họ
these	cái này
thick	dày
thief	tên trộm
thiem	thiêm
thien	thiên
thieu	thiệu
thin	gầy
thing	điều
think	suy nghĩ
this	điều này
thnks	cảm ơn
thoai	thoại
thom	thơm
thon	thon gọn
thongs	dép lê
those	những, cái đó
thot	thốt nốt
thought	nghĩ
thoughtful	chu đáo
thougt	nghĩ
threatened	bị đe dọa
three	số ba
threeday	ba ngày
threeway	ba cách
threw	ném
thro	xuyên qua
through	xuyên qua
thrue	xuyên qua
thua	thừa
thuan	thuận
thubg	côn đồ
thuc	thục
thumb	ngón tay cái
thung	thung lũng
thuong	thường
thuy	thủy
thx	cám ơn
thy	của mày
ticket	vé
ticks	bọ ve
ticks	tích tắc
tidied	ngăn nắp
tidier	ngăn nắp hơn
tidy	ngăn nắp
tie	cà vạt
tien	tiến
tiep	tiệp
tiet	tiết
tiger	con hổ
tigon	hổ sư
tilasin	cá rô phi
time	thời gian
times	lần
timesquare	quảng trường thời đại
timh	thời gian
tin	thiếc
tinfoil	giấy thiếc
tiny	nhỏ bé
tip	tiền boa
tips	lời khuyên
tirant	bậc thang
title	tiêu đề
tittle	nói nhỏ
tjrough	xuyên qua
tkanks	cảm ơn
to	đến
toan	toàn
toast	bánh mì nướng
toaster	máy nướng bánh mì
toasters	lò nướng bánh mì
toasty	ăn ngon
toboggan	xe trượt băng
todo	làm
together	cùng với nhau
toielt	phòng vệ sinh
toilet	phòng vệ sinh
toiletories	đồ vệ sinh cá nhân
toiletteries	đồ dùng vệ sinh
toilletries	đồ vệ sinh cá nhân
toilte	phòng vệ sinh
toki	trượt tuyết
told	kể lại
tolet	hãy để
toll	thu phí
tomatoe	cà chua
tomorrow	ngày mai
ton	tấn
tone	tấn
tonic	thuốc bổ
took	lấy
tooooo	quá
toot	thổi còi
top	hàng đầu
totally	tổng cộng
totsl	toàn bộ
tou	bạn
touch	chạm
tour	chuyến du lịch
tourguide	hướng dẫn viên du lịch
touring	du lịch
tourist	du lịch
tourists	khách du lịch
touristy	khách du lịch
tours	các chuyến du lịch
tours	chuyến tham quan
tout	chào hàng
toute	chào hàng
towards	hướng tới
towells	khăn tắm
towels	khăn tắm
tower	tòa tháp
towers	tháp
town	thị trấn
townhouse	nhà phố
toys	đồ chơi
tra	trà
track	theo dõi
trademills	máy chạy bộ
tradeoff	sự đánh đổi
tragedia	bi kịch
trails	đường mòn
train	xe lửa
trainee	thực tập sinh
training	đào tạo
traintickets	ve xe lửa
tram	xe điện
tran	trần
traning	huấn luyện
tranquil	yên tĩnh
tranquility	yên bình
transit	quá cảnh
translate	phiên dịch
translated	đã dịch
translator	người phiên dịch
transport	vận chuyển
transprt	vận chuyển
trap	bẩy
trasfering	chuyển giao
trash	rác
travel	du lịch
travelblog	blog du lịch
travelbox	hộp du lịch
traveled	đi du lịch
traveler	lữ khách
travelers	du khách
traveling	đi du lịch
travellance	du lịch
traveller	lữ khách
traveller	khách du lịch
travellers	du khách
travellimg	đi du lịch
travels	du lịch
treatment	sự đối xử
tree	cây
treeated	trồng cây
treehouse	nhà trên cây
trees	cây
trek	đi bộ
trekking	đi bộ đường dài
trekking	leo núi
treks	chuyến đi
trend	khuynh hướng
trendy	hợp thời trang
tri	tri kỉ
tribees	bộ lạc
trick	lừa
tricks	thủ thuật
tried	đã thử
triet	triết
trink	đồ vặt
trip	chuyến đi
triple	gấp ba
tripple	vấp ngã
trips	chuyến đi
trom	trôm
trong	trọng
tropic	chí tuyến
tropical	nhiệt đới
trouble	rắc rối
truc	trúc
truely	thực sự
truly	thực sự
trust	lòng tin
trusting	tin tưởng
try	thử
tshirt	áo thun
tuan	anh tuấn
tub	bồn tắm
tube	ống
tue	thứ ba
tuesday	thứ ba
tuibg	kéo mạnh
tukish	thổ nhĩ kỳ
tuna	cá ngừ
tung	tùng
tunnels	địa đạo
tuong	tường
turndown	giảm xuống
tusp	ngà voi
tuyen	tuyền
tuyet	tuyết
twice	hai lần
twin	sinh đôi
twins	sinh đôi
twist	xoắn
type	kiểu
typhoon	bão nhiệt đới
ubran	thành thị
ueen	thiếu niên
ultimate	tối thượng
ultra	cực kỳ
um	ừm
umkempt	nhếch nhác
unacceptable	không thể chấp nhận được
unassuming	khiêm tốn
unavailable	không có sẵn
unawnsered	không được trả lời
unbelievable	không thể tin được
unbelievably	không tin
unbooked	chưa đặt trước
uncel	bỏ chọn
uncomfortable	khó chịu
under	dưới
underdtand	hiểu biết
understaffed	thiếu nhân sự
understand	hiểu biết
understatement	sự nói nhỏ
underwhelming	áp đảo
unenthusiastic	không nhiệt tình
unexpected	bất ngờ
unfogetble	không thể lay chuyển
unforgottable	không thể nào quên
unfortuanatly	không may
unfriedly	không thân thiện
unfriendly	không thân thiện
unintrested	không quan tâm
union	liên hiệp
unit	đơn vị
unity	thống nhất
university	trường đại học
unkindly	không ngoan
uno	không
unoccupied	không có người ở
unpack	giải nén
unplanned	không có kế hoạch
unpleasant	khó chịu
unplesaent	không tiết kiệm
unprofessional	không chuyên nghiệp
unprovoked	vô cớ
unsalty	không có muối
unsympathetic	không thông cảm
untampered	chưa được kiểm tra
untill	hết
unusual	bất thường
up	lên
update	cập nhật
upgrade	nâng cấp
upgraded	nâng cấp
upgrage	nâng cấp
upon	trên
upper	phía trên
uppet	đoạn mã
upsell	bán lại
upselling	lên bán
upsells	bán thêm
upside	ngược lại
upside	lộn ngược
upthere	trên đó
urbanhouse	nhà thành thị
urhome	nhà của em
us	chúng ta
usa	hoa kỳ
usd	đô la mỹ
use	sử dụng
utter	thốt ra
uyen	uyên
vac	bỏ trống
vacances	kỳ nghỉ
vacation	kỳ nghỉ
vacationtrip	chuyến đi nghỉ
vaction	kỳ nghỉ
valentine	lễ tình nhân
vali	dũng cảm
valley	thung lũng
valuable	quý giá
value	giá trị
valued	có giá trị
vani	biến mất
vanity	tự phụ
vannot	không thể
varied	đa dạng
various	đa dạng
ve	đã
veey	rất
vegan	thuần chay
vein	tĩnh mạch
veitnam	việt nam
venue	hội họp
veraemente	hiên ngang
verging	bờ vực
veri	xác minh
verry	tươi vui
vertigo	chóng mặt
very	rất
verygood	rất tốt
verygoof	rất xa vời
verymuch	rất nhiều
vespers	kinh chiều
vet	bác sĩ thú y
vets	bác sĩ thú y
via	thông qua
viatnam	việt nam
viatnamese	tiếng việt
vibe	rung cảm
vibes	rung cảm
vicent	nạn nhân
victory	chiến thắng
vie	tranh giành
vieew	lượt xem
vientam	việt nam
vientiane	viêng chăn
viet	việt
vietinbank	ngân hàng vietinbank
vietnam	việt nam
vietnameese	tiếng việt
vietnames	tiếng việt
vietnamese	tiếng việt
vietnamiese	tiếng việt
vietnamise	tiếng việt
vietnamy	việt nam
vietnan	việt nam
vietnm	việt nam
view	lượt xem
viewfriendly	nhìn thân thiện
views	lượt xem
viking	tên ông vua
vile	hèn hạ
villa	biệt thự
village	làng
villages	làng
villarge	làng
villas	biệt thự
villass	con chó
villla	biệt thự
villlas	biệt thự
vin	sơ vin
vinearl	cây nho
vinosis	vi chứng
vintage	cổ điển
violet	màu tím
violin	đàn vi ô lông
vip	cao cấp
virus	vi-rút
visa	hộ chiếu
vision	tầm nhìn
visit	chuyến thăm
visited	đã đến thăm
visiter	người đến thăm
visiting	thăm viếng
vitenamise	tiếng việt
vitnam	việt nam
vivid	sống động
voan	khăn voan
vodka	rượu vodka
void	vô hiệu
voidable	vô hiệu
volume	âm lượng
vote	bỏ phiếu
voted	bình chọn
voted	đã bình chọn
votere	bình chọn
voting	biểu quyết
voucher	phiếu thưởng
voucher	chứng từ
voyage	hành trình
vuong	vương
wad	một xấp
wait	chờ đợi
waiter	phục vụ nam
waitress	nữ phục vụ
walk	đi bộ
walker	người đi bộ
walkie	máy đi bộ
walkin	bước vào
walking	đi dạo
wall	tường
wallop	bức tường
wanna	muốn
wanted	muốn
ware	đồ
warm	ấm áp
warmly	nồng nhiệt
warmth	sự ấm áp
warmth	ấm áp
warning	cảnh báo
was	đã
washing	rửa
washlet	nhà vệ sinh
wasnt	không
watch	đồng hồ đeo tay
water	nước
waterbungalows	cây nước
waterline	dòng nước
waterpark	công viên nước
waters	nhiều nước
watress	nữ phục vụ
wave	làn sóng
waves	sóng
way	đường
wayfinding	tìm đường
ways	cách
wc	nhà vệ sinh
we	chúng tôi
wear	mặc
weasal	chồn
weater	thời tiết
website	trang mạng
wed	thứ tư
wedding	lễ cưới
weed	cỏ dại
weeding	làm cỏ
weekeind	cuối tuần
weeken	ngày cuối tuần
weekend	ngày cuối tuần
welcome	chào mừng
welcomed	hoan nghênh
welcomerink	chào mừng
welcoming	chào mừng
welcoming	chào đón
well	tốt
wellcome	chào mừng
welldone	làm tốt
welldone	nấu kỹ
welll	hàn
wellnes	sức khỏe
wellness	sức khỏe
welness	sự thân thiện
were	là
west	hướng tây
wester	miền tây
western	miền tây
weve	cỏ dại
whales	cá voi
what	gì
wheel	bánh xe
whelming	tiếng vo ve
when	khi nào
whenever	bất cứ khi nào
where	ở đâu
whew	tiếng kêu
which	cái nào
whils	đánh trống lảng
whit	ý thích
white	trắng
whitehouse	nhà trắng
whole	toàn bộ
wholes	con điếm
whynot	tại sao không
wide	rộng
wife	người vợ
wild	hoang dã
wildland	hoang dã
will	sẽ
willve	cây liễu
win	thắng lợi
wind	gió
windbell	chuông gió
windchimes	chuông gió
windmills	cối xay gió
window	cửa sổ
windows	các cửa sổ
windowview	cửa sổ
windy	có gió
wine	rượu
winter	mùa đông
with	với
witho	với
without	không có
woefully	khốn nạn
wolf	chó sói
wolfpack	bầy sói
wolud	sẽ
womans	phụ nữ
wonder	ngạc nhiên
wonderful	tuyệt vời
wonderfull	tuyệt vời
wont	không
wont	sẽ không
wonton	hoành thánh
woo	gâu gâu
wood	gỗ
woody	thân gỗ
worderfull	lo lắng
work	công việc
works	làm
worlcup	cúp thế giới
world	thế giới
worlde	lo lắng
worldpress	báo chí thế giới
worse	tệ hơn
worse	thật
worst	tệ
worth	đáng giá
worthy	xứng đáng
would	sẽ
wouldn	sẽ không
wouldnt	sẽ không
wowed	kinh ngạc
wows	chúc mừng
wowwowwow	tuyệt tuyệt tuyệt
wpuld	sẽ
writes	viết
written	bằng văn bản
writting	viết lách
xao	xao xuyến
xen	xen kẽ
xoai	xoài
xoan	cây xoan
xouldnt	không thể
xuan	xuân
xui	xui xẻo
yacht	thuyền buồm
yam	mứt
yang	dương
yea	vâng
yeah	vâng
year	năm
yearend	hết năm
years	năm
yellownish	hơi vàng
yen	yên
yes	đúng
yesterday	hôm qua
yogurt	sữa chua
you	bạn
your	của bạn
yourself	bản thân bạn
yourselves	chính bạn
yummy	ngon
yup	vâng
zakuzi	bể sục
zen	thiền học
zero	số không
zest	sự hăng hái
zin	đồ zin
ziplines	dây khóa kéo
zoom	thu phóng